37 33 33 33 33 33 33 33 33 33 33 33 33 33 33 33 33 40 33 33 40 33 33 33 33 33 33 33 33 33 40 33 33 40 33 33 33 33 33 33 33 33 33 33 33 33 33 33 33 38
31 25 25 25 25 25 25 25 25 25 25 25 25 25 25 25 25 31 25 25 31 26 26 26 26 26 26 26 26 26 31 25 25 31 25 25 25 25 25 25 25 25 25 25 25 25 25 25 25 31
31 25 25 25 25 25 25 25 25 25 25 25 25 25 25 25 25 31 25 25 31 26 26 26 26 26 26 26 26 26 31 25 25 31 25 25 25 25 25 25 25 25 25 25 25 25 25 25 25 31
31 25 25 25 25 25 25 25 25 25 25 25 25 25 25 25 25 31 25 25 31 26 26 26 26 26 26 26 26 26 31 25 25 31 25 25 25 25 25 25 25 25 25 25 25 25 25 25 25 31
31 25 25 25 25 25 25 25 25 25 25 25 25 25 25 25 25 31 25 25 31 26 26 26 26 26 26 26 26 26 31 25 25 31 25 25 25 25 25 25 25 25 25 25 25 25 25 25 25 31
31 25 25 25 25 25 25 25 25 25 25 25 25 25 25 25 25 31 25 25 31 26 26 26 26 26 26 26 26 26 31 25 25 31 25 25 25 25 25 25 25 25 25 25 25 25 25 25 25 31
31 25 25 25 25 25 25 25 25 25 25 25 25 25 25 25 25 31 25 25 31 26 26 26 26 26 26 26 26 26 31 25 25 31 25 25 25 25 25 25 25 25 25 25 25 25 25 25 25 31
31 25 25 25 25 25 25 25 25 25 25 25 25 25 25 25 25 31 25 25 31 26 26 26 26 26 26 26 26 26 31 25 25 25 25 25 25 25 25 25 25 25 25 25 25 25 25 25 25 31
31 25 25 25 25 25 25 25 25 25 25 25 25 25 25 25 25 31 25 25 31 26 26 26 26 26 26 26 26 26 31 25 25 25 25 25 25 25 25 25 25 25 25 25 25 25 25 25 25 31
31 25 25 25 25 25 25 25 25 25 25 25 25 25 25 25 25 31 25 25 31 26 26 26 26 26 26 26 26 26 31 25 25 25 25 25 25 25 25 25 25 25 25 25 25 25 25 25 25 31
31 25 25 25 25 25 25 25 25 25 25 25 25 25 25 25 25 25 25 25 31 26 26 26 26 26 26 26 26 26 31 25 25 31 25 25 25 25 25 25 25 25 25 25 25 25 25 25 25 31
31 25 25 25 25 25 25 25 25 25 25 25 25 25 25 25 25 25 25 25 31 26 26 26 26 26 26 26 26 26 31 25 25 31 25 25 25 25 25 25 25 25 25 25 25 25 25 25 25 31
31 25 25 25 25 25 25 25 25 25 25 25 25 25 25 25 25 25 25 25 31 26 26 26 26 26 26 26 26 26 31 25 25 32 33 33 33 33 33 33 33 33 33 33 33 33 33 33 33 34
31 25 25 25 25 25 25 25 25 25 25 25 25 25 25 25 25 31 25 25 31 26 26 26 26 26 26 26 26 26 31 25 25 31 25 25 25 25 25 25 25 25 25 25 25 25 25 25 25 31
31 25 25 25 25 25 25 25 25 25 25 25 25 25 25 25 25 31 25 25 31 26 26 26 26 26 26 26 26 26 31 25 25 31 25 25 25 25 25 25 25 25 25 25 25 25 25 25 25 31
31 25 25 25 25 25 25 25 25 25 25 25 25 25 25 25 25 31 25 25 31 26 26 26 26 26 26 26 26 26 31 25 25 25 25 25 25 25 25 25 25 25 25 25 25 25 25 25 25 31
32 33 33 33 33 33 33 33 33 33 33 33 33 33 33 33 33 34 25 25 31 26 26 26 26 26 26 26 26 26 31 25 25 25 25 25 25 25 25 25 25 25 25 25 25 25 25 25 25 31
31 25 25 25 25 25 25 25 25 25 25 25 25 25 25 25 25 31 25 25 31 26 26 26 26 26 26 26 26 26 31 25 25 25 25 25 25 25 25 25 25 25 25 25 25 25 25 25 25 31
31 25 25 25 25 25 25 25 25 25 25 25 25 25 25 25 25 31 25 25 25 25 25 25 25 25 25 25 25 25 25 25 25 31 25 25 25 25 25 25 25 25 25 25 25 25 25 25 25 31
31 25 25 25 25 25 25 25 25 25 25 25 25 25 25 25 25 31 25 25 25 25 25 25 25 25 25 25 25 25 25 25 25 31 25 25 25 25 25 25 25 25 25 25 25 25 25 25 25 31
31 25 25 25 25 25 25 25 25 25 25 25 25 25 25 25 25 31 25 25 25 25 25 25 25 25 25 25 25 25 25 25 25 31 25 25 25 25 25 25 25 25 25 25 25 25 25 25 25 31
31 25 25 25 25 25 25 25 25 25 25 25 25 25 25 25 25 31 25 25 31 26 26 26 26 26 26 26 26 26 31 25 25 31 25 25 25 25 25 25 25 25 25 25 25 25 25 25 25 31
31 25 25 25 25 25 25 25 25 25 25 25 25 25 25 25 25 31 25 25 31 26 26 26 26 26 26 26 26 26 31 25 25 31 25 25 25 25 25 25 25 25 25 25 25 25 25 25 25 31
31 25 25 25 25 25 25 25 25 25 25 25 25 25 25 25 25 31 25 25 31 26 26 26 26 26 26 26 26 26 31 27 28 31 25 25 25 25 25 25 25 25 25 25 25 25 25 25 25 31
31 25 25 25 25 25 25 25 25 25 25 25 25 25 25 25 25 31 25 25 31 26 26 26 26 26 26 26 26 26 31 27 28 31 25 25 25 25 25 25 25 25 25 25 25 25 25 25 25 31
31 25 25 25 25 25 25 25 25 25 25 25 25 25 25 25 25 31 25 25 31 26 26 26 26 26 26 26 26 26 26 26 26 32 33 33 33 33 33 33 33 33 33 33 33 33 33 33 33 34
31 25 25 25 25 25 25 25 25 25 25 25 25 25 25 25 25 25 25 25 31 26 26 26 26 26 26 26 26 26 26 26 26 31 25 25 25 25 25 25 25 25 25 25 25 25 25 25 25 31
31 25 25 25 25 25 25 25 25 25 25 25 25 25 25 25 25 25 25 25 31 26 26 26 26 26 26 26 26 26 26 26 26 31 25 25 25 25 25 25 25 25 25 25 25 25 25 25 25 31
31 25 25 25 25 25 25 25 25 25 25 25 25 25 25 25 25 25 25 25 31 26 26 26 26 26 26 26 26 26 26 26 26 31 25 25 25 25 25 25 25 25 25 25 25 25 25 25 25 31
31 25 25 25 25 25 25 25 25 25 25 25 25 25 25 25 25 31 25 25 31 26 26 26 26 26 26 26 26 26 26 26 26 31 25 25 25 51 52 25 51 52 25 51 52 25 25 25 25 31
31 25 25 25 25 25 25 25 25 25 25 25 25 25 25 25 25 31 25 25 31 26 26 26 26 26 26 26 26 26 26 26 26 31 25 25 25 51 52 25 51 52 25 51 52 25 25 25 25 31
32 33 33 33 33 33 33 33 33 33 33 33 33 33 33 33 33 34 25 25 31 26 26 26 26 26 26 26 26 26 26 26 26 25 25 25 25 51 52 25 51 52 25 51 52 25 25 25 25 31
31 25 25 25 25 25 25 25 25 25 25 25 25 25 25 25 25 31 25 25 31 26 26 26 26 26 26 26 26 26 26 26 26 25 25 25 25 51 52 25 51 52 25 51 52 25 25 25 25 31
31 25 25 25 25 25 25 25 25 25 25 25 25 25 25 25 25 31 25 25 31 26 26 26 26 26 26 26 26 26 26 26 26 25 25 25 25 51 52 25 51 52 25 51 52 25 25 25 25 31
31 25 25 25 25 25 25 25 25 25 25 25 25 25 25 25 25 31 25 25 31 26 26 26 26 26 26 26 26 26 26 26 26 31 25 25 25 51 52 25 51 52 25 51 52 25 25 25 25 31
31 25 25 25 25 25 25 25 25 25 25 25 25 25 25 25 25 31 25 25 31 26 26 26 26 26 26 26 26 26 26 26 26 31 25 25 25 51 52 25 51 52 25 51 52 25 25 25 25 31
31 25 25 25 25 25 25 25 25 25 25 25 25 25 25 25 25 31 25 25 31 26 26 26 26 26 26 26 26 26 26 26 26 31 25 25 25 51 52 25 51 52 25 51 52 25 25 25 25 31
31 25 25 25 25 25 25 25 25 25 25 25 25 25 25 25 25 31 25 25 31 26 26 26 26 26 26 26 26 26 26 26 26 31 25 25 25 51 52 25 51 52 25 51 52 25 25 25 25 31
31 25 25 25 25 25 25 25 25 25 25 25 25 25 25 25 25 31 25 25 31 26 26 26 26 26 26 26 26 26 26 26 26 31 25 25 25 51 52 25 51 52 25 51 52 25 25 25 25 31
31 25 25 25 25 25 25 25 25 25 25 25 25 25 25 25 25 31 25 25 31 26 26 26 26 26 26 26 26 26 26 26 26 31 25 25 25 51 52 25 51 52 25 51 52 25 25 25 25 31
31 25 25 25 25 25 25 25 25 25 25 25 25 25 25 25 25 31 25 25 31 26 26 26 26 26 26 26 26 26 26 26 26 31 25 25 25 51 52 25 51 52 25 51 52 25 25 25 25 31
31 25 25 25 25 25 25 25 25 25 25 25 25 25 25 25 25 31 25 25 31 26 26 26 26 26 26 26 26 26 26 26 26 31 25 25 25 51 52 25 51 52 25 51 52 25 25 25 25 31
31 25 25 25 25 25 25 25 25 25 25 25 25 25 25 25 25 31 25 25 31 26 26 26 26 26 26 26 26 26 26 26 26 31 25 25 25 51 52 25 51 52 25 51 52 25 25 25 25 31
31 25 25 25 25 25 25 25 25 25 25 25 25 25 25 25 25 25 25 25 31 26 26 26 26 26 26 26 26 26 26 26 26 31 25 25 25 51 52 25 51 52 25 51 52 25 25 25 25 31
31 25 25 25 25 25 25 25 25 25 25 25 25 25 25 25 25 25 25 25 31 26 26 26 26 26 26 26 26 26 26 26 26 31 25 25 25 51 52 25 51 52 25 51 52 25 25 25 25 31
31 25 25 25 25 25 25 25 25 25 25 25 25 25 25 25 25 25 25 25 31 26 26 26 26 26 26 26 26 26 26 26 26 31 25 25 25 51 52 25 51 52 25 51 52 25 25 25 25 31
31 25 25 25 25 25 25 25 25 25 25 25 25 25 25 25 25 31 25 25 31 26 26 26 26 26 26 26 26 26 26 26 26 31 25 25 25 25 25 25 25 25 25 25 25 25 25 25 25 31
31 25 25 25 25 25 25 25 25 25 25 25 25 25 25 25 25 31 25 25 31 26 26 26 26 26 26 26 26 26 26 26 26 31 25 25 25 25 25 25 25 25 25 25 25 25 25 25 25 31
31 25 25 25 25 25 25 25 25 25 25 25 25 25 25 25 25 31 25 25 31 26 26 26 26 26 26 26 26 26 26 26 26 31 25 25 25 25 25 25 25 25 25 25 25 25 25 25 25 31
35 33 33 33 33 33 33 33 33 33 33 33 33 33 33 33 33 39 33 33 39 33 33 33 33 25 25 25 33 33 33 33 33 39 33 33 33 33 33 33 33 33 33 33 33 33 33 33 33 36