30 30 30 30 30 30 30 30 30 30 30 30 30 30 30 30 30 30 30 30 30 30 30 30 30 30 30 30 30 30 30 30 30 30 30 30 30 30 30 30 30 30 30 30 30 30 30 30 30 30
30 25 25 25 25 25 25 25 25 25 25 25 25 25 25 25 25 30 25 25 30 26 26 26 26 26 26 26 26 26 31 25 25 31 25 25 25 25 25 25 25 25 25 25 25 25 25 25 25 30
30 25 25 25 25 25 25 25 25 25 25 25 25 25 25 25 25 30 25 25 30 26 26 26 26 26 26 26 26 26 31 25 25 31 25 25 25 25 25 25 25 25 25 25 25 25 25 25 25 30
30 25 25 25 25 25 25 25 25 25 25 25 25 25 25 25 25 30 25 25 30 26 26 26 26 26 26 26 26 26 31 25 25 31 25 25 25 25 25 25 25 25 25 25 25 25 25 25 25 30
30 25 25 25 25 25 25 25 25 25 25 25 25 25 25 25 25 30 25 25 25 26 26 26 26 26 26 26 26 26 31 25 25 31 25 25 25 25 25 25 25 25 25 25 25 25 25 25 25 30
30 25 25 25 25 25 25 25 25 25 25 25 25 25 25 25 25 30 25 25 25 26 26 26 26 26 26 26 26 26 31 25 25 31 25 25 25 25 25 25 25 25 25 25 25 25 25 25 25 30
30 25 25 25 25 25 25 25 25 25 25 25 25 25 25 25 25 30 25 25 30 26 26 26 26 26 26 26 26 26 31 25 25 31 25 25 25 25 25 25 25 25 25 25 25 25 25 25 25 30
30 25 25 25 25 25 25 25 25 25 25 25 25 25 25 25 25 30 25 25 30 26 26 26 26 26 26 26 26 26 31 25 25 25 25 25 25 25 25 25 25 25 25 25 25 25 25 25 25 30
30 25 25 25 25 25 25 25 25 25 25 25 25 25 25 25 25 30 25 25 30 26 26 26 26 26 26 26 26 26 31 25 25 25 25 25 25 25 25 25 25 25 25 25 25 25 25 25 25 30
30 25 25 25 25 25 25 25 25 25 25 25 25 25 25 25 25 30 25 25 30 26 26 26 26 26 26 26 26 26 31 25 25 25 25 25 25 25 25 25 25 25 25 25 25 25 25 25 25 30
30 25 25 25 25 25 25 25 25 25 25 25 25 25 25 25 25 25 25 25 30 26 26 26 26 26 26 26 26 26 31 25 25 31 25 25 25 25 25 25 25 25 25 25 25 25 25 25 25 30
30 25 25 25 25 25 25 25 25 25 25 25 25 25 25 25 25 25 25 25 30 26 26 26 26 26 26 26 26 26 31 25 25 31 25 25 25 25 25 25 25 25 25 25 25 25 25 25 25 30
30 25 25 25 25 25 25 25 25 25 25 25 25 25 25 25 25 25 25 25 30 26 26 26 26 26 26 26 26 26 31 25 25 32 33 33 33 33 33 33 33 33 33 33 33 33 33 33 33 30
30 25 25 25 25 25 25 25 25 25 25 25 25 25 25 25 25 30 25 25 30 26 26 26 26 26 26 26 26 26 31 25 25 31 25 25 25 25 25 25 25 25 25 25 25 25 25 25 25 30
30 25 25 25 25 25 25 25 25 25 25 25 25 25 25 25 25 30 25 25 30 26 26 26 26 26 26 26 26 26 31 25 25 31 25 25 25 25 25 25 25 25 25 25 25 25 25 25 25 30
30 25 25 25 25 25 25 25 25 25 25 25 25 25 25 25 25 30 25 25 30 26 26 26 26 26 26 26 26 26 31 25 25 25 25 25 25 25 25 25 25 25 25 25 25 25 25 25 25 30
30 30 30 30 30 30 30 30 30 30 30 30 30 30 30 30 30 30 25 25 30 26 26 26 26 26 26 26 26 26 31 25 25 25 25 25 25 25 25 25 25 25 25 25 25 25 25 25 25 30
30 25 25 25 25 25 25 25 25 25 25 25 25 25 25 25 25 30 25 25 30 26 26 26 26 26 26 26 26 26 31 25 25 25 25 25 25 25 25 25 25 25 25 25 25 25 25 25 25 30
30 25 25 25 25 25 25 25 25 25 25 25 25 25 25 25 25 30 25 25 25 25 25 25 25 25 25 25 25 25 25 25 25 31 25 25 25 25 25 25 25 25 25 25 25 25 25 25 25 30
30 25 25 25 25 25 25 25 25 25 25 25 25 25 25 25 25 30 25 25 25 25 25 25 25 25 25 25 25 25 25 25 25 31 25 25 25 25 25 25 25 25 25 25 25 25 25 25 25 30
30 25 25 25 25 25 25 25 25 25 25 25 25 25 25 25 25 30 25 25 25 25 25 25 25 25 25 25 25 25 25 25 25 31 25 25 25 25 25 25 25 25 25 25 25 25 25 25 25 30
30 25 25 25 25 25 25 25 25 25 25 25 25 25 25 25 25 30 25 25 30 26 26 26 26 26 26 26 26 26 31 25 25 31 25 25 25 25 25 25 25 25 25 25 25 25 25 25 25 30
30 25 25 25 25 25 25 25 25 25 25 25 25 25 25 25 25 30 25 25 30 26 26 26 26 26 26 26 26 26 31 25 25 31 25 25 25 25 25 25 25 25 25 25 25 25 25 25 25 30
30 25 25 25 25 25 25 25 25 25 25 25 25 25 25 25 25 30 25 25 30 26 26 26 26 26 26 26 26 26 31 27 28 31 25 25 25 25 25 25 25 25 25 25 25 25 25 25 25 30
30 25 25 25 25 25 25 25 25 25 25 25 25 25 25 25 25 30 25 25 30 26 26 26 26 26 26 26 26 26 31 27 28 31 25 25 25 25 25 25 25 25 25 25 25 25 25 25 25 30
30 25 25 25 25 25 25 25 25 25 25 25 25 25 25 25 25 30 25 25 30 26 26 26 26 26 26 26 26 26 26 26 26 32 33 33 33 33 33 33 33 33 33 33 33 33 33 33 33 30
30 25 25 25 25 25 25 25 25 25 25 25 25 25 25 25 25 25 25 25 30 26 26 26 26 26 26 26 26 26 26 26 26 31 25 25 25 25 25 25 25 25 25 25 25 25 25 25 25 30
30 25 25 25 25 25 25 25 25 25 25 25 25 25 25 25 25 25 25 25 30 26 26 26 26 26 26 26 26 26 26 26 26 31 25 25 25 25 25 25 25 25 25 25 25 25 25 25 25 30
30 25 25 25 25 25 25 25 25 25 25 25 25 25 25 25 25 25 25 25 30 26 26 26 26 26 26 26 26 26 26 26 26 31 25 25 25 25 25 25 25 25 25 25 25 25 25 25 25 30
30 25 25 25 25 25 25 25 25 25 25 25 25 25 25 25 25 30 25 25 30 26 26 26 26 26 26 26 26 26 26 26 26 31 25 25 25 51 52 51 52 51 52 51 52 25 25 25 25 30
30 25 25 25 25 25 25 25 25 25 25 25 25 25 25 25 25 30 25 25 30 26 26 26 26 26 26 26 26 26 26 26 26 31 25 25 25 51 52 51 52 51 52 51 52 25 25 25 25 30
30 30 30 30 30 30 30 30 30 30 30 30 30 30 30 30 30 30 25 25 30 26 26 26 26 26 26 26 26 26 26 26 26 25 25 25 25 51 52 51 52 51 52 51 52 25 25 25 25 30
30 25 25 25 25 25 25 25 25 25 25 25 25 25 25 25 25 30 25 25 30 26 26 26 26 26 26 26 26 26 26 26 26 25 25 25 25 51 52 51 52 51 52 51 52 25 25 25 25 30
30 25 25 25 25 25 25 25 25 25 25 25 25 25 25 25 25 30 25 25 30 26 26 26 26 26 26 26 26 26 26 26 26 25 25 25 25 51 52 51 52 51 52 51 52 25 25 25 25 30
30 25 25 25 25 25 25 25 25 25 25 25 25 25 25 25 25 30 25 25 30 26 26 26 26 26 26 26 26 26 26 26 26 31 25 25 25 51 52 51 52 51 52 51 52 25 25 25 25 30
30 25 25 25 25 25 25 25 25 25 25 25 25 25 25 25 25 30 25 25 30 26 26 26 26 26 26 26 26 26 26 26 26 31 25 25 25 51 52 51 52 51 52 51 52 25 25 25 25 30
30 25 25 25 25 25 25 25 25 25 25 25 25 25 25 25 25 30 25 25 30 26 26 26 26 26 26 26 26 26 26 26 26 31 25 25 25 51 52 51 52 51 52 51 52 25 25 25 25 30
30 25 25 25 25 25 25 25 25 25 25 25 25 25 25 25 25 30 25 25 30 26 26 26 26 26 26 26 26 26 26 26 26 31 25 25 25 51 52 51 52 51 52 51 52 25 25 25 25 30
30 25 25 25 25 25 25 25 25 25 25 25 25 25 25 25 25 30 25 25 30 26 26 26 26 26 26 26 26 26 26 26 26 31 25 25 25 51 52 51 52 51 52 51 52 25 25 25 25 30
30 25 25 25 25 25 25 25 25 25 25 25 25 25 25 25 25 30 25 25 30 26 26 26 26 26 26 26 26 26 26 26 26 31 25 25 25 51 52 51 52 51 52 51 52 25 25 25 25 30
30 25 25 25 25 25 25 25 25 25 25 25 25 25 25 25 25 30 25 25 30 26 26 26 26 26 26 26 26 26 26 26 26 31 25 25 25 51 52 51 52 51 52 51 52 25 25 25 25 30
30 25 25 25 25 25 25 25 25 25 25 25 25 25 25 25 25 30 25 25 30 26 26 26 26 26 26 26 26 26 26 26 26 31 25 25 25 51 52 51 52 51 52 51 52 25 25 25 25 30
30 25 25 25 25 25 25 25 25 25 25 25 25 25 25 25 25 30 25 25 30 26 26 26 26 26 26 26 26 26 26 26 26 31 25 25 25 51 52 51 52 51 52 51 52 25 25 25 25 30
30 25 25 25 25 25 25 25 25 25 25 25 25 25 25 25 25 25 25 25 30 26 26 26 26 26 26 26 26 26 26 26 26 31 25 25 25 51 52 51 52 51 52 51 52 25 25 25 25 30
30 25 25 25 25 25 25 25 25 25 25 25 25 25 25 25 25 25 25 25 30 26 26 26 26 26 26 26 26 26 26 26 26 31 25 25 25 51 52 51 52 51 52 51 52 25 25 25 25 30
30 25 25 25 25 25 25 25 25 25 25 25 25 25 25 25 25 25 25 25 30 26 26 26 26 26 26 26 26 26 26 26 26 31 25 25 25 51 52 51 52 51 52 51 52 25 25 25 25 30
30 25 25 25 25 25 25 25 25 25 25 25 25 25 25 25 25 30 25 25 30 26 26 26 26 26 26 26 26 26 26 26 26 31 25 25 25 25 25 25 25 25 25 25 25 25 25 25 25 30
30 25 25 25 25 25 25 25 25 25 25 25 25 25 25 25 25 30 25 25 30 26 26 26 26 26 26 26 26 26 26 26 26 31 25 25 25 25 25 25 25 25 25 25 25 25 25 25 25 30
30 25 25 25 25 25 25 25 25 25 25 25 25 25 25 25 25 30 25 25 30 26 26 26 26 26 26 26 26 26 26 26 26 31 25 25 25 25 25 25 25 25 25 25 25 25 25 25 25 30
30 30 30 30 30 30 30 30 30 30 30 30 30 30 30 30 30 30 30 30 30 30 30 30 30 25 25 25 30 30 30 30 30 30 30 30 30 30 30 30 30 30 30 30 30 30 30 30 30 30