30 30 30 30 30 30 30 30 30 30 30 30 30 30 30 30 30 30 30 30 30 30 30 30 30 30 30 30 30 30 30 30 30 30 30 30 30 30 30 30 30 30 30 30 30 30 30 30 30 30
30 25 25 25 25 25 25 25 25 25 25 25 25 25 25 25 25 30 25 25 30 26 26 26 26 26 26 26 26 26 30 25 25 30 25 25 25 25 25 25 25 25 25 25 25 25 25 25 25 30
30 25 25 25 25 25 25 25 25 25 25 25 25 25 25 25 25 30 25 25 30 26 26 26 26 26 26 26 26 26 30 25 25 30 25 25 25 25 25 25 25 25 25 25 25 25 25 25 25 30
30 25 25 25 25 25 25 25 25 25 25 25 25 25 25 25 25 30 25 25 30 26 26 26 26 26 26 26 26 26 30 25 25 30 25 25 25 25 25 25 25 25 25 25 25 25 25 25 25 30
30 25 25 25 25 25 25 25 25 25 25 25 25 25 25 25 25 30 25 25 25 26 26 26 26 26 26 26 26 26 25 25 25 30 25 25 25 25 25 25 25 25 25 25 25 25 25 25 25 30
30 25 25 25 25 25 25 25 25 25 25 25 25 25 25 25 25 30 25 25 25 26 26 26 26 26 26 26 26 26 25 25 25 30 25 25 25 25 25 25 25 25 25 25 25 25 25 25 25 30
30 25 25 25 25 25 25 25 25 25 25 25 25 25 25 25 25 30 25 25 30 26 26 26 26 26 26 26 26 26 30 25 25 30 25 25 25 25 25 25 25 25 25 25 25 25 25 25 25 30
30 25 25 25 25 25 25 25 25 25 25 25 25 25 25 25 25 30 25 25 30 26 26 26 26 26 26 26 26 26 30 25 25 25 25 25 25 25 25 25 25 25 25 25 25 25 25 25 25 30
30 25 25 25 25 25 25 25 25 25 25 25 25 25 25 25 25 30 25 25 30 26 26 26 26 26 26 26 26 26 30 25 25 25 25 25 25 25 25 25 25 25 25 25 25 25 25 25 25 30
30 25 25 25 25 25 25 25 25 25 25 25 25 25 25 25 25 30 25 25 30 26 26 26 26 26 26 26 26 26 30 25 25 25 25 25 25 25 25 25 25 25 25 25 25 25 25 25 25 30
30 25 25 25 25 25 25 25 25 25 25 25 25 25 25 25 25 25 25 25 30 26 26 26 26 26 26 26 26 26 30 25 25 30 25 25 25 25 25 25 25 25 25 25 25 25 25 25 25 30
30 25 25 25 25 25 25 25 25 25 25 25 25 25 25 25 25 25 25 25 30 26 26 26 26 26 26 26 26 26 30 25 25 30 25 25 25 25 25 25 25 25 25 25 25 25 25 25 25 30
30 25 25 25 25 25 25 25 25 25 25 25 25 25 25 25 25 25 25 25 30 26 26 26 26 26 26 26 26 26 30 25 25 30 30 30 30 30 30 30 30 30 30 30 30 30 30 30 30 30
30 25 25 25 25 25 25 25 25 25 25 25 25 25 25 25 25 30 25 25 30 26 26 26 26 26 26 26 26 26 30 25 25 30 25 25 25 25 25 25 25 25 25 25 25 25 25 25 25 30
30 25 25 25 25 25 25 25 25 25 25 25 25 25 25 25 25 30 25 25 30 26 26 26 26 26 26 26 26 26 30 25 25 30 25 25 25 25 25 25 25 25 25 25 25 25 25 25 25 30
30 25 25 25 25 25 25 25 25 25 25 25 25 25 25 25 25 30 25 25 30 26 26 26 26 26 26 26 26 26 30 25 25 25 25 25 25 25 25 25 25 25 25 25 25 25 25 25 25 30
30 30 30 30 30 30 30 30 30 30 30 30 30 30 30 30 30 30 25 25 30 26 26 26 26 26 26 26 26 26 30 25 25 25 25 25 25 25 25 25 25 25 25 25 25 25 25 25 25 30
30 25 25 25 25 25 25 25 25 25 25 25 25 25 25 25 25 30 25 25 30 26 26 26 26 26 26 26 26 26 30 25 25 25 25 25 25 25 25 25 25 25 25 25 25 25 25 25 25 30
30 25 25 25 25 25 25 25 25 25 25 25 25 25 25 25 25 30 25 25 25 25 25 25 25 25 25 25 25 25 25 25 25 30 25 25 25 25 25 25 25 25 25 25 25 25 25 25 25 30
30 25 25 25 25 25 25 25 25 25 25 25 25 25 25 25 25 30 25 25 25 25 25 25 25 25 25 25 25 25 25 25 25 30 25 25 25 25 25 25 25 25 25 25 25 25 25 25 25 30
30 25 25 25 25 25 25 25 25 25 25 25 25 25 25 25 25 30 25 25 25 25 25 25 25 25 25 25 25 25 25 25 25 30 25 25 25 25 25 25 25 25 25 25 25 25 25 25 25 30
30 25 25 25 25 25 25 25 25 25 25 25 25 25 25 25 25 30 25 25 30 26 26 26 26 26 26 26 26 26 30 25 25 30 25 25 25 25 25 25 25 25 25 25 25 25 25 25 25 30
30 25 25 25 25 25 25 25 25 25 25 25 25 25 25 25 25 30 25 25 30 26 26 26 26 26 26 26 26 26 30 25 25 30 25 25 25 25 25 25 25 25 25 25 25 25 25 25 25 30
30 25 25 25 25 25 25 25 25 25 25 25 25 25 25 25 25 30 25 25 30 26 26 26 26 26 26 26 26 26 30 25 25 30 25 25 25 25 25 25 25 25 25 25 25 25 25 25 25 30
30 25 25 25 25 25 25 25 25 25 25 25 25 25 25 25 25 30 25 25 30 26 26 26 26 26 26 26 26 26 30 25 25 30 25 25 25 25 25 25 25 25 25 25 25 25 25 25 25 30
30 25 25 25 25 25 25 25 25 25 25 25 25 25 25 25 25 30 25 25 30 26 26 26 26 26 26 26 26 26 26 26 26 30 30 30 30 30 30 30 30 30 30 30 30 30 30 30 30 30
30 25 25 25 25 25 25 25 25 25 25 25 25 25 25 25 25 25 25 25 30 26 26 26 26 26 26 26 26 26 26 26 26 30 25 25 25 25 25 25 25 25 25 25 25 25 25 25 25 30
30 25 25 25 25 25 25 25 25 25 25 25 25 25 25 25 25 25 25 25 30 26 26 26 26 26 26 26 26 26 26 26 26 30 25 25 25 25 25 25 25 25 25 25 25 25 25 25 25 30
30 25 25 25 25 25 25 25 25 25 25 25 25 25 25 25 25 25 25 25 30 26 26 26 26 26 26 26 26 26 26 26 26 30 25 25 25 25 25 25 25 25 25 25 25 25 25 25 25 30
30 25 25 25 25 25 25 25 25 25 25 25 25 25 25 25 25 30 25 25 30 26 26 26 26 26 26 26 26 26 26 26 26 30 25 25 25 25 25 25 25 25 25 25 25 25 25 25 25 30
30 25 25 25 25 25 25 25 25 25 25 25 25 25 25 25 25 30 25 25 30 26 26 26 26 26 26 26 26 26 26 26 26 30 25 25 25 25 25 25 25 25 25 25 25 25 25 25 25 30
30 30 30 30 30 30 30 30 30 30 30 30 30 30 30 30 30 30 25 25 30 26 26 26 26 26 26 26 26 26 26 26 26 25 25 25 25 25 25 25 25 25 25 25 25 25 25 25 25 30
30 25 25 25 25 25 25 25 25 25 25 25 25 25 25 25 25 30 25 25 30 26 26 26 26 26 26 26 26 26 26 26 26 25 25 25 25 25 25 25 25 25 25 25 25 25 25 25 25 30
30 25 25 25 25 25 25 25 25 25 25 25 25 25 25 25 25 30 25 25 30 26 26 26 26 26 26 26 26 26 26 26 26 25 25 25 25 25 25 25 25 25 25 25 25 25 25 25 25 30
30 25 25 25 25 25 25 25 25 25 25 25 25 25 25 25 25 30 25 25 30 26 26 26 26 26 26 26 26 26 26 26 26 30 25 25 25 25 25 25 25 25 25 25 25 25 25 25 25 30
30 25 25 25 25 25 25 25 25 25 25 25 25 25 25 25 25 30 25 25 30 26 26 26 26 26 26 26 26 26 26 26 26 30 25 25 25 25 25 25 25 25 25 25 25 25 25 25 25 30
30 25 25 25 25 25 25 25 25 25 25 25 25 25 25 25 25 30 25 25 30 26 26 26 26 26 26 26 26 26 26 26 26 30 25 25 25 25 25 25 25 25 25 25 25 25 25 25 25 30
30 25 25 25 25 25 25 25 25 25 25 25 25 25 25 25 25 30 25 25 30 26 26 26 26 26 26 26 26 26 26 26 26 30 25 25 25 25 25 25 25 25 25 25 25 25 25 25 25 30
30 25 25 25 25 25 25 25 25 25 25 25 25 25 25 25 25 30 25 25 30 26 26 26 26 26 26 26 26 26 26 26 26 30 25 25 25 25 25 25 25 25 25 25 25 25 25 25 25 30
30 25 25 25 25 25 25 25 25 25 25 25 25 25 25 25 25 30 25 25 30 26 26 26 26 26 26 26 26 26 26 26 26 30 25 25 25 25 25 25 25 25 25 25 25 25 25 25 25 30
30 25 25 25 25 25 25 25 25 25 25 25 25 25 25 25 25 30 25 25 30 26 26 26 26 26 26 26 26 26 26 26 26 30 25 25 25 25 25 25 25 25 25 25 25 25 25 25 25 30
30 25 25 25 25 25 25 25 25 25 25 25 25 25 25 25 25 30 25 25 30 26 26 26 26 26 26 26 26 26 26 26 26 30 25 25 25 25 25 25 25 25 25 25 25 25 25 25 25 30
30 25 25 25 25 25 25 25 25 25 25 25 25 25 25 25 25 30 25 25 30 26 26 26 26 26 26 26 26 26 26 26 26 30 25 25 25 25 25 25 25 25 25 25 25 25 25 25 25 30
30 25 25 25 25 25 25 25 25 25 25 25 25 25 25 25 25 25 25 25 30 26 26 26 26 26 26 26 26 26 26 26 26 30 25 25 25 25 25 25 25 25 25 25 25 25 25 25 25 30
30 25 25 25 25 25 25 25 25 25 25 25 25 25 25 25 25 25 25 25 30 26 26 26 26 26 26 26 26 26 26 26 26 30 25 25 25 25 25 25 25 25 25 25 25 25 25 25 25 30
30 25 25 25 25 25 25 25 25 25 25 25 25 25 25 25 25 25 25 25 30 26 26 26 26 26 26 26 26 26 26 26 26 30 25 25 25 25 25 25 25 25 25 25 25 25 25 25 25 30
30 25 25 25 25 25 25 25 25 25 25 25 25 25 25 25 25 30 25 25 30 26 26 26 26 26 26 26 26 26 26 26 26 30 25 25 25 25 25 25 25 25 25 25 25 25 25 25 25 30
30 25 25 25 25 25 25 25 25 25 25 25 25 25 25 25 25 30 25 25 30 26 26 26 26 26 26 26 26 26 26 26 26 30 25 25 25 25 25 25 25 25 25 25 25 25 25 25 25 30
30 25 25 25 25 25 25 25 25 25 25 25 25 25 25 25 25 30 25 25 30 26 26 26 26 26 26 26 26 26 26 26 26 30 25 25 25 25 25 25 25 25 25 25 25 25 25 25 25 30
30 30 30 30 30 30 30 30 30 30 30 30 30 30 30 30 30 30 30 30 30 30 30 30 30 25 25 25 30 30 30 30 30 30 30 30 30 30 30 30 30 30 30 30 30 30 30 30 30 30