33 33 33 33 33 33 33 33 33 33 33 33 33 33 33 33 33 33 33 33 33 33 33 33 33 33 33 33 33 33 33 33 33 33 33 33 33 33 33 33 33 33 33 33 33 33 33 33 33 33
31 25 25 25 25 25 25 25 25 25 25 25 25 25 25 25 25 31 25 25 31 26 26 26 26 26 26 26 26 26 31 25 25 31 25 25 25 25 25 25 25 25 25 25 25 25 25 25 25 31
31 25 25 25 25 25 25 25 25 25 25 25 25 25 25 25 25 31 25 25 31 26 26 26 26 26 26 26 26 26 31 25 25 31 25 25 25 25 25 25 25 25 25 25 25 25 25 25 25 31
31 25 25 25 25 25 25 25 25 25 25 25 25 25 25 25 25 31 25 25 31 26 26 26 26 26 26 26 26 26 31 25 25 31 25 25 25 25 25 25 25 25 25 25 25 25 25 25 25 31
31 25 25 25 25 25 25 25 25 25 25 25 25 25 25 25 25 31 25 25 31 26 26 26 26 26 26 26 26 26 31 25 25 31 25 25 25 25 25 25 25 25 25 25 25 25 25 25 25 31
31 25 25 25 25 25 25 25 25 25 25 25 25 25 25 25 25 31 25 25 31 26 26 26 26 26 26 26 26 26 31 25 25 31 25 25 25 25 25 25 25 25 25 25 25 25 25 25 25 31
31 25 25 25 25 25 25 25 25 25 25 25 25 25 25 25 25 31 25 25 31 26 26 26 26 26 26 26 26 26 31 25 25 31 25 25 25 25 25 25 25 25 25 25 25 25 25 25 25 31
31 25 25 25 25 25 25 25 25 25 25 25 25 25 25 25 25 31 25 25 31 26 26 26 26 26 26 26 26 26 31 25 25 25 25 25 25 25 25 25 25 25 25 25 25 25 25 25 25 31
31 25 25 25 25 25 25 25 25 25 25 25 25 25 25 25 25 31 25 25 31 26 26 26 26 26 26 26 26 26 31 25 25 25 25 25 25 25 25 25 25 25 25 25 25 25 25 25 25 31
31 25 25 25 25 25 25 25 25 25 25 25 25 25 25 25 25 31 25 25 31 26 26 26 26 26 26 26 26 26 31 25 25 25 25 25 25 25 25 25 25 25 25 25 25 25 25 25 25 31
31 25 25 25 25 25 25 25 25 25 25 25 25 25 25 25 25 25 25 25 31 26 26 26 26 26 26 26 26 26 31 25 25 31 25 25 25 25 25 25 25 25 25 25 25 25 25 25 25 31
31 25 25 25 25 25 25 25 25 25 25 25 25 25 25 25 25 25 25 25 31 26 26 26 26 26 26 26 26 26 31 25 25 31 25 25 25 25 25 25 25 25 25 25 25 25 25 25 25 31
31 25 25 25 25 25 25 25 25 25 25 25 25 25 25 25 25 25 25 25 31 26 26 26 26 26 26 26 26 26 31 25 25 32 33 33 33 33 33 33 33 33 33 33 33 33 33 33 33 31
31 25 25 25 25 25 25 25 25 25 25 25 25 25 25 25 25 31 25 25 31 26 26 26 26 26 26 26 26 26 31 25 25 31 25 25 25 25 25 25 25 25 25 25 25 25 25 25 25 31
31 25 25 25 25 25 25 25 25 25 25 25 25 25 25 25 25 31 25 25 31 26 26 26 26 26 26 26 26 26 31 25 25 31 25 25 25 25 25 25 25 25 25 25 25 25 25 25 25 31
31 25 25 25 25 25 25 25 25 25 25 25 25 25 25 25 25 31 25 25 31 26 26 26 26 26 26 26 26 26 31 25 25 25 25 25 25 25 25 25 25 25 25 25 25 25 25 25 25 31
31 33 33 33 33 33 33 33 33 33 33 33 33 33 33 33 33 31 25 25 31 26 26 26 26 26 26 26 26 26 31 25 25 25 25 25 25 25 25 25 25 25 25 25 25 25 25 25 25 31
31 25 25 25 25 25 25 25 25 25 25 25 25 25 25 25 25 31 25 25 31 26 26 26 26 26 26 26 26 26 31 25 25 25 25 25 25 25 25 25 25 25 25 25 25 25 25 25 25 31
31 25 25 25 25 25 25 25 25 25 25 25 25 25 25 25 25 31 25 25 25 25 25 25 25 25 25 25 25 25 25 25 25 31 25 25 25 25 25 25 25 25 25 25 25 25 25 25 25 31
31 25 25 25 25 25 25 25 25 25 25 25 25 25 25 25 25 31 25 25 25 25 25 25 25 25 25 25 25 25 25 25 25 31 25 25 25 25 25 25 25 25 25 25 25 25 25 25 25 31
31 25 25 25 25 25 25 25 25 25 25 25 25 25 25 25 25 31 25 25 25 25 25 25 25 25 25 25 25 25 25 25 25 31 25 25 25 25 25 25 25 25 25 25 25 25 25 25 25 31
31 25 25 25 25 25 25 25 25 25 25 25 25 25 25 25 25 31 25 25 31 26 26 26 26 26 26 26 26 26 31 25 25 31 25 25 25 25 25 25 25 25 25 25 25 25 25 25 25 31
31 25 25 25 25 25 25 25 25 25 25 25 25 25 25 25 25 31 25 25 31 26 26 26 26 26 26 26 26 26 31 25 25 31 25 25 25 25 25 25 25 25 25 25 25 25 25 25 25 31
31 25 25 25 25 25 25 25 25 25 25 25 25 25 25 25 25 31 25 25 31 26 26 26 26 26 26 26 26 26 31 27 28 31 25 25 25 25 25 25 25 25 25 25 25 25 25 25 25 31
31 25 25 25 25 25 25 25 25 25 25 25 25 25 25 25 25 31 25 25 31 26 26 26 26 26 26 26 26 26 31 27 28 31 25 25 25 25 25 25 25 25 25 25 25 25 25 25 25 31
31 25 25 25 25 25 25 25 25 25 25 25 25 25 25 25 25 31 25 25 31 26 26 26 26 26 26 26 26 26 26 26 26 32 33 33 33 33 33 33 33 33 33 33 33 33 33 33 33 31
31 25 25 25 25 25 25 25 25 25 25 25 25 25 25 25 25 25 25 25 31 26 26 26 26 26 26 26 26 26 26 26 26 31 25 25 25 25 25 25 25 25 25 25 25 25 25 25 25 31
31 25 25 25 25 25 25 25 25 25 25 25 25 25 25 25 25 25 25 25 31 26 26 26 26 26 26 26 26 26 26 26 26 31 25 25 25 25 25 25 25 25 25 25 25 25 25 25 25 31
31 25 25 25 25 25 25 25 25 25 25 25 25 25 25 25 25 25 25 25 31 26 26 26 26 26 26 26 26 26 26 26 26 31 25 25 25 25 25 25 25 25 25 25 25 25 25 25 25 31
31 25 25 25 25 25 25 25 25 25 25 25 25 25 25 25 25 31 25 25 31 26 26 26 26 26 26 26 26 26 26 26 26 31 25 25 25 51 52 25 51 52 25 51 52 25 25 25 25 31
31 25 25 25 25 25 25 25 25 25 25 25 25 25 25 25 25 31 25 25 31 26 26 26 26 26 26 26 26 26 26 26 26 31 25 25 25 51 52 25 51 52 25 51 52 25 25 25 25 31
31 33 33 33 33 33 33 33 33 33 33 33 33 33 33 33 33 31 25 25 31 26 26 26 26 26 26 26 26 26 26 26 26 25 25 25 25 51 52 25 51 52 25 51 52 25 25 25 25 31
31 25 25 25 25 25 25 25 25 25 25 25 25 25 25 25 25 31 25 25 31 26 26 26 26 26 26 26 26 26 26 26 26 25 25 25 25 51 52 25 51 52 25 51 52 25 25 25 25 31
31 25 25 25 25 25 25 25 25 25 25 25 25 25 25 25 25 31 25 25 31 26 26 26 26 26 26 26 26 26 26 26 26 25 25 25 25 51 52 25 51 52 25 51 52 25 25 25 25 31
31 25 25 25 25 25 25 25 25 25 25 25 25 25 25 25 25 31 25 25 31 26 26 26 26 26 26 26 26 26 26 26 26 31 25 25 25 51 52 25 51 52 25 51 52 25 25 25 25 31
31 25 25 25 25 25 25 25 25 25 25 25 25 25 25 25 25 31 25 25 31 26 26 26 26 26 26 26 26 26 26 26 26 31 25 25 25 51 52 25 51 52 25 51 52 25 25 25 25 31
31 25 25 25 25 25 25 25 25 25 25 25 25 25 25 25 25 31 25 25 31 26 26 26 26 26 26 26 26 26 26 26 26 31 25 25 25 51 52 25 51 52 25 51 52 25 25 25 25 31
31 25 25 25 25 25 25 25 25 25 25 25 25 25 25 25 25 31 25 25 31 26 26 26 26 26 26 26 26 26 26 26 26 31 25 25 25 51 52 25 51 52 25 51 52 25 25 25 25 31
31 25 25 25 25 25 25 25 25 25 25 25 25 25 25 25 25 31 25 25 31 26 26 26 26 26 26 26 26 26 26 26 26 31 25 25 25 51 52 25 51 52 25 51 52 25 25 25 25 31
31 25 25 25 25 25 25 25 25 25 25 25 25 25 25 25 25 31 25 25 31 26 26 26 26 26 26 26 26 26 26 26 26 31 25 25 25 51 52 25 51 52 25 51 52 25 25 25 25 31
31 25 25 25 25 25 25 25 25 25 25 25 25 25 25 25 25 31 25 25 31 26 26 26 26 26 26 26 26 26 26 26 26 31 25 25 25 51 52 25 51 52 25 51 52 25 25 25 25 31
31 25 25 25 25 25 25 25 25 25 25 25 25 25 25 25 25 31 25 25 31 26 26 26 26 26 26 26 26 26 26 26 26 31 25 25 25 51 52 25 51 52 25 51 52 25 25 25 25 31
31 25 25 25 25 25 25 25 25 25 25 25 25 25 25 25 25 31 25 25 31 26 26 26 26 26 26 26 26 26 26 26 26 31 25 25 25 51 52 25 51 52 25 51 52 25 25 25 25 31
31 25 25 25 25 25 25 25 25 25 25 25 25 25 25 25 25 25 25 25 31 26 26 26 26 26 26 26 26 26 26 26 26 31 25 25 25 51 52 25 51 52 25 51 52 25 25 25 25 31
31 25 25 25 25 25 25 25 25 25 25 25 25 25 25 25 25 25 25 25 31 26 26 26 26 26 26 26 26 26 26 26 26 31 25 25 25 51 52 25 51 52 25 51 52 25 25 25 25 31
31 25 25 25 25 25 25 25 25 25 25 25 25 25 25 25 25 25 25 25 31 26 26 26 26 26 26 26 26 26 26 26 26 31 25 25 25 51 52 25 51 52 25 51 52 25 25 25 25 31
31 25 25 25 25 25 25 25 25 25 25 25 25 25 25 25 25 31 25 25 31 26 26 26 26 26 26 26 26 26 26 26 26 31 25 25 25 25 25 25 25 25 25 25 25 25 25 25 25 31
31 25 25 25 25 25 25 25 25 25 25 25 25 25 25 25 25 31 25 25 31 26 26 26 26 26 26 26 26 26 26 26 26 31 25 25 25 25 25 25 25 25 25 25 25 25 25 25 25 31
31 25 25 25 25 25 25 25 25 25 25 25 25 25 25 25 25 31 25 25 31 26 26 26 26 26 26 26 26 26 26 26 26 31 25 25 25 25 25 25 25 25 25 25 25 25 25 25 25 31
33 33 33 33 33 33 33 33 33 33 33 33 33 33 33 33 33 33 33 33 33 33 33 33 33 25 25 25 33 33 33 33 33 33 33 33 33 33 33 33 33 33 33 33 33 33 33 33 33 33