37 33 33 33 33 33 33 33 33 33 33 33 33 33 33 33 33 33 33 33 33 33 33 33 33 33 33 33 33 33 33 33 33 33 33 33 33 33 23 23 23 33 33 33 33 33 33 33 33 38
31 23 23 23 23 23 23 23 23 23 23 23 23 23 23 23 23 23 23 23 23 23 23 23 23 23 23 23 23 23 23 23 23 23 23 23 23 23 23 23 23 23 23 23 23 23 23 23 23 31
31 23 23 23 23 23 23 23 23 23 23 23 23 23 23 23 23 23 23 23 23 23 23 23 23 23 23 23 23 23 23 23 23 23 23 23 23 23 23 23 23 23 23 23 23 23 23 23 23 31
31 23 23 23 23 23 23 23 23 23 23 23 23 23 23 23 23 23 23 23 23 23 23 23 23 23 23 23 23 23 23 23 23 23 23 23 23 23 23 23 23 23 23 23 23 23 23 23 23 31
31 23 23 23 23 23 23 23 23 23 23 23 23 23 23 23 23 23 23 23 23 23 23 23 23 23 23 23 23 23 23 23 23 23 23 23 23 23 23 23 23 23 23 23 23 23 23 23 23 31
31 23 23 23 23 23 23 23 23 23 23 23 23 23 23 23 23 23 23 23 23 23 23 23 23 23 23 23 23 23 23 23 23 23 23 23 23 23 23 23 23 23 23 23 23 23 23 23 23 31
31 23 23 23 23 23 23 23 23 23 23 23 23 23 23 23 23 23 23 23 23 23 23 23 23 23 23 23 23 23 23 23 23 23 23 23 23 23 23 23 23 23 23 23 23 23 23 23 23 31
31 23 23 23 23 23 23 23 23 23 23 23 23 23 23 23 23 23 23 23 23 23 23 23 23 23 23 23 23 23 23 23 23 23 23 23 23 23 23 23 23 23 23 23 23 23 23 23 23 31
31 23 23 23 23 23 23 23 23 23 23 23 23 23 23 23 23 23 23 23 23 23 23 23 23 23 23 23 23 23 23 23 23 23 23 23 23 23 23 23 23 23 23 23 23 23 23 23 23 31
31 23 23 23 23 23 23 23 23 23 23 23 23 23 23 23 23 23 23 23 23 23 23 23 23 23 23 23 23 23 23 23 23 23 23 23 23 23 23 23 23 23 23 23 23 23 23 23 23 31
32 33 33 33 33 33 33 33 33 23 23 23 33 33 33 33 33 33 33 33 38 23 23 23 23 23 23 23 23 23 23 23 33 40 33 33 33 33 33 33 33 33 33 33 33 33 33 33 33 34
31 23 23 23 23 23 23 23 23 23 23 23 23 23 23 23 23 23 23 23 31 23 23 23 23 23 23 23 23 23 23 33 23 31 23 23 23 23 23 23 23 23 23 23 23 23 23 23 23 31
31 23 23 23 23 23 23 23 23 23 23 23 23 23 23 23 23 23 23 23 31 23 23 23 23 23 23 23 23 23 33 23 23 31 23 23 23 23 23 23 23 23 23 23 23 23 23 23 23 31
31 23 23 23 23 23 23 23 23 23 23 23 23 23 23 23 23 23 23 23 31 23 23 23 23 23 23 23 23 33 23 23 23 31 23 23 23 23 23 23 23 23 23 23 23 23 23 23 23 31
31 23 23 23 23 23 23 23 23 23 23 23 23 23 23 23 23 23 23 23 31 23 23 23 23 23 23 23 33 23 23 23 23 31 23 23 23 23 23 23 23 23 23 23 23 23 23 23 23 31
31 23 23 23 23 23 23 23 23 23 23 23 23 23 23 23 23 23 23 23 31 23 23 23 23 23 23 23 33 23 23 23 23 23 23 23 23 23 23 23 23 23 23 23 23 23 23 23 23 31
31 23 23 23 23 23 23 23 23 23 23 23 23 23 23 23 23 23 23 23 31 23 23 23 23 23 23 23 33 23 23 23 23 23 23 23 23 23 23 23 23 23 23 23 23 23 23 23 23 31
31 23 23 23 23 23 23 23 23 23 23 23 23 23 23 23 23 23 23 23 31 23 23 23 23 23 23 23 33 23 23 23 23 31 23 23 23 23 23 23 23 23 23 23 23 23 23 23 23 31
31 23 23 23 23 23 23 23 23 23 23 23 23 23 23 23 23 23 23 23 31 23 23 23 23 23 23 23 33 23 23 23 23 31 23 23 23 23 23 23 23 23 23 23 23 23 23 23 23 31
31 23 23 23 23 23 23 23 23 23 23 23 23 23 23 23 23 23 23 23 31 23 23 23 23 23 23 23 23 33 23 23 23 31 23 23 23 23 23 23 23 23 23 23 23 23 23 23 23 31
31 23 23 23 23 23 23 23 23 23 23 23 23 23 23 23 23 23 23 23 31 23 23 23 23 23 23 23 23 23 33 23 23 31 23 23 23 23 23 23 23 23 23 23 23 23 23 23 23 31
31 23 23 23 23 23 23 23 23 23 23 23 23 23 23 23 23 23 23 23 31 23 23 23 23 23 23 23 23 23 23 33 23 31 23 23 23 23 23 23 23 23 23 23 23 23 23 23 23 31
31 23 23 23 23 23 23 23 23 23 23 23 23 23 23 23 23 23 23 23 31 23 23 23 23 23 23 23 23 23 23 23 33 39 33 33 33 33 33 33 33 33 33 33 33 33 33 33 33 34
31 23 23 23 23 23 23 23 23 23 23 23 23 23 23 23 23 23 23 23 31 23 23 23 23 23 23 23 23 23 23 23 23 23 23 23 23 23 23 23 23 23 23 23 23 23 23 23 23 31
31 23 23 23 23 23 23 23 23 23 23 23 23 23 23 23 23 23 23 23 31 23 23 23 23 23 23 23 23 23 23 23 23 23 23 23 23 23 23 23 23 23 23 23 23 23 23 23 23 31
31 23 23 23 23 23 23 23 23 23 23 23 23 23 23 23 23 23 23 23 31 23 23 23 23 23 23 23 23 23 23 23 23 23 23 23 23 23 23 23 23 23 23 23 23 23 23 23 23 31
31 23 23 23 23 23 23 23 23 23 23 23 23 23 23 23 23 23 23 23 31 23 23 23 23 23 23 23 23 23 23 23 23 23 23 23 23 23 23 23 23 23 23 23 23 23 23 23 23 31
31 23 23 23 23 23 23 23 23 23 23 23 23 23 23 23 23 23 23 23 31 23 23 23 23 23 23 23 23 23 23 23 23 23 23 23 23 23 23 23 23 23 23 23 23 23 23 23 23 31
31 23 23 23 23 23 23 23 23 23 23 23 23 23 23 23 23 23 23 23 31 23 23 23 23 23 23 23 23 23 23 23 23 23 23 23 23 23 23 23 23 23 23 23 23 23 23 23 23 31
31 23 23 23 23 23 23 23 23 23 23 23 23 23 23 23 23 23 23 23 31 23 23 23 23 23 23 23 23 23 23 23 23 23 23 23 23 23 23 23 23 23 23 23 23 23 23 23 23 31
31 23 23 23 23 23 23 23 23 23 23 23 23 23 23 23 23 23 23 23 31 23 23 23 23 23 23 23 23 23 23 23 23 23 23 23 23 23 23 23 23 23 23 23 23 23 23 23 23 31
35 33 33 33 33 33 33 33 33 33 33 33 33 33 33 33 33 33 33 33 39 33 33 23 23 23 33 33 33 33 33 33 33 33 33 33 33 33 33 33 33 33 33 33 33 33 33 33 33 36