37 33 33 33 33 33 33 33 33 33 33 33 33 33 33 33 33 33 33 33 33 33 33 33 33 33 33 33 33 33 33 33 33 33 33 33 33 33 33 33 33 33 33 33 33 33 33 33 33 38
31 25 25 25 25 25 25 25 25 25 25 25 25 25 25 25 25 25 25 25 25 25 25 25 25 25 25 25 25 25 25 25 25 25 25 25 25 25 25 25 25 25 25 25 25 25 25 25 25 31
31 25 25 25 25 25 25 25 25 25 25 25 25 25 25 25 25 25 25 25 25 25 25 25 25 25 25 25 25 25 25 25 25 25 25 25 25 25 25 25 25 25 25 25 25 25 25 25 25 31
31 24 24 24 24 24 24 25 25 25 25 25 25 25 25 25 25 25 25 25 25 25 25 25 25 25 25 25 25 25 25 25 25 25 25 25 25 25 25 25 25 25 25 25 25 25 25 25 25 31
31 24 24 24 24 24 24 25 25 25 25 25 25 25 25 25 25 25 25 25 25 25 25 25 25 25 25 25 25 25 25 25 25 25 25 25 25 25 25 25 25 25 25 25 25 25 25 25 25 31
31 24 24 24 24 24 24 25 25 25 25 25 25 25 25 25 25 25 25 25 25 25 25 25 25 25 25 25 25 25 25 25 25 25 25 25 25 25 25 25 25 25 25 25 25 25 25 25 25 31
31 24 24 24 24 24 24 25 25 25 52 51 25 25 25 52 51 25 25 25 52 51 25 25 25 52 51 25 25 25 52 51 25 25 25 52 51 25 25 25 52 51 25 25 25 52 51 25 25 31
31 24 24 24 24 24 24 25 25 25 52 51 25 25 25 52 51 25 25 25 52 51 25 25 25 52 51 25 25 25 52 51 25 25 25 52 51 25 25 25 52 51 25 25 25 52 51 25 25 31
31 24 24 24 24 24 24 25 25 25 52 51 25 25 25 52 51 25 25 25 52 51 25 25 25 52 51 25 25 25 52 51 25 25 25 52 51 25 25 25 52 51 25 25 25 52 51 25 25 31
31 24 24 24 24 24 24 25 25 25 52 51 25 25 25 52 51 25 25 25 52 51 25 25 25 52 51 25 25 25 52 51 25 25 25 52 51 25 25 25 52 51 25 25 25 52 51 25 25 31
31 24 24 24 24 24 24 25 25 25 52 51 25 25 25 52 51 25 25 25 52 51 25 25 25 52 51 25 25 25 52 51 25 25 25 52 51 25 25 25 52 51 25 25 25 52 51 25 25 31
31 24 24 24 24 24 24 25 25 25 52 51 25 25 25 52 51 25 25 25 52 51 25 25 25 52 51 25 25 25 52 51 25 25 25 52 51 25 25 25 52 51 25 25 25 52 51 25 25 31
31 24 24 24 24 24 24 25 25 25 52 51 25 25 25 52 51 25 25 25 52 51 25 25 25 52 51 25 25 25 52 51 25 25 25 52 51 25 25 25 52 51 25 25 25 52 51 25 25 31
31 24 24 24 24 24 24 25 25 25 52 51 25 25 25 52 51 25 25 25 52 51 25 25 25 52 51 25 25 25 52 51 25 25 25 52 51 25 25 25 52 51 25 25 25 52 51 25 25 31
31 24 24 24 24 24 24 25 25 25 52 51 25 25 25 52 51 25 25 25 52 51 25 25 25 52 51 25 25 25 52 51 25 25 25 52 51 25 25 25 52 51 25 25 25 52 51 25 25 31
31 24 24 24 24 24 24 25 25 25 52 51 25 25 25 52 51 25 25 25 52 51 25 25 25 52 51 25 25 25 52 51 25 25 25 52 51 25 25 25 52 51 25 25 25 52 51 25 25 31
31 24 24 24 24 24 24 25 25 25 52 51 25 25 25 52 51 25 25 25 52 51 25 25 25 52 51 25 25 25 52 51 25 25 25 52 51 25 25 25 52 51 25 25 25 52 51 25 25 31
31 24 24 24 24 24 24 25 25 25 52 51 25 25 25 52 51 25 25 25 52 51 25 25 25 52 51 25 25 25 52 51 25 25 25 52 51 25 25 25 52 51 25 25 25 52 51 25 25 31
31 24 24 24 24 24 24 25 25 25 52 51 25 25 25 52 51 25 25 25 52 51 25 25 25 52 51 25 25 25 52 51 25 25 25 52 51 25 25 25 52 51 25 25 25 52 51 25 25 31
31 24 24 24 24 24 24 25 25 25 52 51 25 25 25 52 51 25 25 25 52 51 25 25 25 52 51 25 25 25 52 51 25 25 25 52 51 25 25 25 52 51 25 25 25 52 51 25 25 31
31 24 24 24 24 24 24 25 25 25 52 51 25 25 25 52 51 25 25 25 52 51 25 25 25 52 51 25 25 25 52 51 25 25 25 52 51 25 25 25 52 51 25 25 25 52 51 25 25 31
31 24 24 24 24 24 24 25 25 25 52 51 25 25 25 52 51 25 25 25 52 51 25 25 25 52 51 25 25 25 52 51 25 25 25 52 51 25 25 25 52 51 25 25 25 52 51 25 25 31
31 24 24 24 24 24 24 25 25 25 52 51 25 25 25 52 51 25 25 25 52 51 25 25 25 52 51 25 25 25 52 51 25 25 25 52 51 25 25 25 52 51 25 25 25 52 51 25 25 31
31 24 24 24 24 24 24 25 25 25 52 51 25 25 25 52 51 25 25 25 52 51 25 25 25 52 51 25 25 25 52 51 25 25 25 52 51 25 25 25 52 51 25 25 25 52 51 25 25 31
31 24 24 24 24 24 24 25 25 25 52 51 25 25 25 52 51 25 25 25 52 51 25 25 25 52 51 25 25 25 52 51 25 25 25 52 51 25 25 25 52 51 25 25 25 52 51 25 25 31
31 24 24 24 24 24 24 25 25 25 25 25 25 25 25 25 25 25 25 25 25 25 25 25 25 25 25 25 25 25 25 25 25 25 25 25 25 25 25 25 25 25 25 25 25 25 25 25 25 31
31 24 24 24 24 24 24 25 25 25 25 25 25 25 25 25 25 25 25 25 25 25 25 25 25 25 25 25 25 25 25 25 25 25 25 25 25 25 25 25 25 25 25 25 25 25 25 25 25 31
31 27 28 24 24 24 24 25 25 25 25 25 25 25 25 25 25 25 25 25 25 25 25 25 25 25 25 25 25 25 25 25 25 25 25 25 25 25 25 25 25 25 25 25 25 25 25 25 25 31
31 25 25 25 25 25 25 25 25 25 25 25 25 25 25 25 25 25 25 25 25 25 25 25 25 25 25 25 25 25 25 25 25 25 25 25 25 25 25 25 25 25 25 25 25 25 25 25 25 31
31 25 25 25 25 25 25 25 25 25 25 25 25 25 25 25 25 25 25 25 25 25 25 25 25 25 25 25 25 25 25 25 25 25 25 25 25 25 25 25 25 25 25 25 25 25 25 25 25 31
31 25 25 25 25 25 25 25 25 25 25 25 25 25 25 25 25 25 25 25 25 25 25 25 25 25 25 25 25 25 25 25 25 25 25 25 25 25 25 25 25 25 25 25 25 25 25 25 25 33
35 33 33 33 33 33 33 33 33 33 33 33 33 33 33 33 33 33 33 33 33 33 33 33 33 33 33 33 33 33 25 25 25 33 33 33 33 33 33 33 33 33 33 33 33 33 33 33 33 36