30 30 30 30 30 30 30 30 30 30 30 30 30 30 30 30 30 30 30 30 30 30 30 30 30 30 30 30 30 30 30 30 30 30 30 30 30 30 30 30 30 30 30 30 30 30 30 30 30 30
30 25 25 25 25 25 25 25 25 25 25 25 25 25 25 25 25 25 25 25 25 25 25 25 25 25 25 25 25 25 25 25 25 25 25 25 25 25 25 25 25 25 25 25 25 25 25 25 25 30
30 25 25 25 25 25 25 25 25 25 25 25 25 25 25 25 25 25 25 25 25 25 25 25 25 25 25 25 25 25 25 25 25 25 25 25 25 25 25 25 25 25 25 25 25 25 25 25 25 30
30 24 24 24 24 24 24 25 25 25 25 25 25 25 25 25 25 25 25 25 25 25 25 25 25 25 25 25 25 25 25 25 25 25 25 25 25 25 25 25 25 25 25 25 25 25 25 25 25 30
30 24 24 24 24 24 24 25 25 25 25 25 25 25 25 25 25 25 25 25 25 25 25 25 25 25 25 25 25 25 25 25 25 25 25 25 25 25 25 25 25 25 25 25 25 25 25 25 25 30
30 24 24 24 24 24 24 25 25 25 25 25 25 25 25 25 25 25 25 25 25 25 25 25 25 25 25 25 25 25 25 25 25 25 25 25 25 25 25 25 25 25 25 25 25 25 25 25 25 30
30 24 24 24 24 24 24 25 25 25 52 51 25 25 25 52 51 25 25 25 52 51 25 25 25 52 51 25 25 25 52 51 25 25 25 52 51 25 25 25 52 51 25 25 25 52 51 25 25 30 
30 24 24 24 24 24 24 25 25 25 52 51 25 25 25 52 51 25 25 25 52 51 25 25 25 52 51 25 25 25 52 51 25 25 25 52 51 25 25 25 52 51 25 25 25 52 51 25 25 30 
30 24 24 24 24 24 24 25 25 25 52 51 25 25 25 52 51 25 25 25 52 51 25 25 25 52 51 25 25 25 52 51 25 25 25 52 51 25 25 25 52 51 25 25 25 52 51 25 25 30 
30 24 24 24 24 24 24 25 25 25 52 51 25 25 25 52 51 25 25 25 52 51 25 25 25 52 51 25 25 25 52 51 25 25 25 52 51 25 25 25 52 51 25 25 25 52 51 25 25 30 
30 24 24 24 24 24 24 25 25 25 52 51 25 25 25 52 51 25 25 25 52 51 25 25 25 52 51 25 25 25 52 51 25 25 25 52 51 25 25 25 52 51 25 25 25 52 51 25 25 30 
30 24 24 24 24 24 24 25 25 25 52 51 25 25 25 52 51 25 25 25 52 51 25 25 25 52 51 25 25 25 52 51 25 25 25 52 51 25 25 25 52 51 25 25 25 52 51 25 25 30 
30 24 24 24 24 24 24 25 25 25 52 51 25 25 25 52 51 25 25 25 52 51 25 25 25 52 51 25 25 25 52 51 25 25 25 52 51 25 25 25 52 51 25 25 25 52 51 25 25 30 
30 24 24 24 24 24 24 25 25 25 52 51 25 25 25 52 51 25 25 25 52 51 25 25 25 52 51 25 25 25 52 51 25 25 25 52 51 25 25 25 52 51 25 25 25 52 51 25 25 30 
30 24 24 24 24 24 24 25 25 25 52 51 25 25 25 52 51 25 25 25 52 51 25 25 25 52 51 25 25 25 52 51 25 25 25 52 51 25 25 25 52 51 25 25 25 52 51 25 25 30 
30 24 24 24 24 24 24 25 25 25 52 51 25 25 25 52 51 25 25 25 52 51 25 25 25 52 51 25 25 25 52 51 25 25 25 52 51 25 25 25 52 51 25 25 25 52 51 25 25 30 
30 24 24 24 24 24 24 25 25 25 52 51 25 25 25 52 51 25 25 25 52 51 25 25 25 52 51 25 25 25 52 51 25 25 25 52 51 25 25 25 52 51 25 25 25 52 51 25 25 30 
30 24 24 24 24 24 24 25 25 25 52 51 25 25 25 52 51 25 25 25 52 51 25 25 25 52 51 25 25 25 52 51 25 25 25 52 51 25 25 25 52 51 25 25 25 52 51 25 25 30 
30 24 24 24 24 24 24 25 25 25 52 51 25 25 25 52 51 25 25 25 52 51 25 25 25 52 51 25 25 25 52 51 25 25 25 52 51 25 25 25 52 51 25 25 25 52 51 25 25 30 
30 24 24 24 24 24 24 25 25 25 52 51 25 25 25 52 51 25 25 25 52 51 25 25 25 52 51 25 25 25 52 51 25 25 25 52 51 25 25 25 52 51 25 25 25 52 51 25 25 30 
30 24 24 24 24 24 24 25 25 25 52 51 25 25 25 52 51 25 25 25 52 51 25 25 25 52 51 25 25 25 52 51 25 25 25 52 51 25 25 25 52 51 25 25 25 52 51 25 25 30 
30 24 24 24 24 24 24 25 25 25 52 51 25 25 25 52 51 25 25 25 52 51 25 25 25 52 51 25 25 25 52 51 25 25 25 52 51 25 25 25 52 51 25 25 25 52 51 25 25 30 
30 24 24 24 24 24 24 25 25 25 52 51 25 25 25 52 51 25 25 25 52 51 25 25 25 52 51 25 25 25 52 51 25 25 25 52 51 25 25 25 52 51 25 25 25 52 51 25 25 30 
30 24 24 24 24 24 24 25 25 25 52 51 25 25 25 52 51 25 25 25 52 51 25 25 25 52 51 25 25 25 52 51 25 25 25 52 51 25 25 25 52 51 25 25 25 52 51 25 25 30 
30 24 24 24 24 24 24 25 25 25 52 51 25 25 25 52 51 25 25 25 52 51 25 25 25 52 51 25 25 25 52 51 25 25 25 52 51 25 25 25 52 51 25 25 25 52 51 25 25 30 
30 24 24 24 24 24 24 25 25 25 25 25 25 25 25 25 25 25 25 25 25 25 25 25 25 25 25 25 25 25 25 25 25 25 25 25 25 25 25 25 25 25 25 25 25 25 25 25 25 30
30 24 24 24 24 24 24 25 25 25 25 25 25 25 25 25 25 25 25 25 25 25 25 25 25 25 25 25 25 25 25 25 25 25 25 25 25 25 25 25 25 25 25 25 25 25 25 25 25 30
30 27 28 24 24 24 24 25 25 25 25 25 25 25 25 25 25 25 25 25 25 25 25 25 25 25 25 25 25 25 25 25 25 25 25 25 25 25 25 25 25 25 25 25 25 25 25 25 25 30
30 25 25 25 25 25 25 25 25 25 25 25 25 25 25 25 25 25 25 25 25 25 25 25 25 25 25 25 25 25 25 25 25 25 25 25 25 25 25 25 25 25 25 25 25 25 25 25 25 30
30 25 25 25 25 25 25 25 25 25 25 25 25 25 25 25 25 25 25 25 25 25 25 25 25 25 25 25 25 25 25 25 25 25 25 25 25 25 25 25 25 25 25 25 25 25 25 25 25 30
30 25 25 25 25 25 25 25 25 25 25 25 25 25 25 25 25 25 25 25 25 25 25 25 25 25 25 25 25 25 25 25 25 25 25 25 25 25 25 25 25 25 25 25 25 25 25 25 25 30
30 30 30 30 30 30 30 30 30 30 30 30 30 30 30 30 30 30 30 30 30 30 30 30 30 30 30 30 30 30 25 25 25 30 30 30 30 30 30 30 30 30 30 30 30 30 30 30 30 30