30 30 30 30 30 30 30 30 30 30 30 30 30 30 30 30 30 30 30 30 30 30 30 30 30 30 30 30 30 30 30 30 30 30 30 30 30 30 23 23 23 30 30 30 30 30 30 30 30 30
30 23 23 23 23 23 23 23 23 23 23 23 23 23 23 23 23 23 23 23 23 23 23 23 23 23 23 23 23 23 23 23 23 23 23 23 23 23 23 23 23 23 23 23 23 23 23 23 23 30
30 23 23 23 23 23 23 23 23 23 23 23 23 23 23 23 23 23 23 23 23 23 23 23 23 23 23 23 23 23 23 23 23 23 23 23 23 23 23 23 23 23 23 23 23 23 23 23 23 30
30 23 23 23 23 23 23 23 23 23 23 23 23 23 23 23 23 23 23 23 23 23 23 23 23 23 23 23 23 23 23 23 23 23 23 23 23 23 23 23 23 23 23 23 23 23 23 23 23 30
30 23 23 23 23 23 23 23 23 23 23 23 23 23 23 23 23 23 23 23 23 23 23 23 23 23 23 23 23 23 23 23 23 23 23 23 23 23 23 23 23 23 23 23 23 23 23 23 23 30
30 23 23 23 23 23 23 23 23 23 23 23 23 23 23 23 23 23 23 23 23 23 23 23 23 23 23 23 23 23 23 23 23 23 23 23 23 23 23 23 23 23 23 23 23 23 23 23 23 30
30 23 23 23 23 23 23 23 23 23 23 23 23 23 23 23 23 23 23 23 23 23 23 23 23 23 23 23 23 23 23 23 23 23 23 23 23 23 23 23 23 23 23 23 23 23 23 23 23 30
30 23 23 23 23 23 23 23 23 23 23 23 23 23 23 23 23 23 23 23 23 23 23 23 23 23 23 23 23 23 23 23 23 23 23 23 23 23 23 23 23 23 23 23 23 23 23 23 23 30
30 23 23 23 23 23 23 23 23 23 23 23 23 23 23 23 23 23 23 23 23 23 23 23 23 23 23 23 23 23 23 23 23 23 23 23 23 23 23 23 23 23 23 23 23 23 23 23 23 30
30 23 23 23 23 23 23 23 23 23 23 23 23 23 23 23 23 23 23 23 23 23 23 23 23 23 23 23 23 23 23 23 23 23 23 23 23 23 23 23 23 23 23 23 23 23 23 23 23 30
30 30 30 30 30 30 30 30 30 23 23 23 30 30 30 30 30 30 30 30 30 23 23 23 23 23 23 23 23 23 23 23 30 30 30 30 30 30 30 30 30 30 30 30 30 30 30 30 30 30
30 23 23 23 23 23 23 23 23 23 23 23 23 23 23 23 23 23 23 23 30 23 23 23 23 23 23 23 23 23 23 30 23 30 23 23 23 23 23 23 23 23 23 23 23 23 23 23 23 30
30 23 23 23 23 23 23 23 23 23 23 23 23 23 23 23 23 23 23 23 30 23 23 23 23 23 23 23 23 23 30 23 23 30 23 23 23 23 23 23 23 23 23 23 23 23 23 23 23 30
30 23 23 23 23 23 23 23 23 23 23 23 23 23 23 23 23 23 23 23 30 23 23 23 23 23 23 23 23 30 23 23 23 30 23 23 23 23 23 23 23 23 23 23 23 23 23 23 23 30
30 23 23 23 23 23 23 23 23 23 23 23 23 23 23 23 23 23 23 23 30 23 23 23 23 23 23 23 30 23 23 23 23 30 23 23 23 23 23 23 23 23 23 23 23 23 23 23 23 30
30 23 23 23 23 23 23 23 23 23 23 23 23 23 23 23 23 23 23 23 30 23 23 23 23 23 23 23 30 23 23 23 23 23 23 23 23 23 23 23 23 23 23 23 23 23 23 23 23 30
30 23 23 23 23 23 23 23 23 23 23 23 23 23 23 23 23 23 23 23 30 23 23 23 23 23 23 23 30 23 23 23 23 23 23 23 23 23 23 23 23 23 23 23 23 23 23 23 23 30
30 23 23 23 23 23 23 23 23 23 23 23 23 23 23 23 23 23 23 23 30 23 23 23 23 23 23 23 30 23 23 23 23 30 23 23 23 23 23 23 23 23 23 23 23 23 23 23 23 30
30 23 23 23 23 23 23 23 23 23 23 23 23 23 23 23 23 23 23 23 30 23 23 23 23 23 23 23 30 23 23 23 23 30 23 23 23 23 23 23 23 23 23 23 23 23 23 23 23 30
30 23 23 23 23 23 23 23 23 23 23 23 23 23 23 23 23 23 23 23 30 23 23 23 23 23 23 23 23 30 23 23 23 30 23 23 23 23 23 23 23 23 23 23 23 23 23 23 23 30
30 23 23 23 23 23 23 23 23 23 23 23 23 23 23 23 23 23 23 23 30 23 23 23 23 23 23 23 23 23 30 23 23 30 23 23 23 23 23 23 23 23 23 23 23 23 23 23 23 30
30 23 23 23 23 23 23 23 23 23 23 23 23 23 23 23 23 23 23 23 30 23 23 23 23 23 23 23 23 23 23 30 23 30 23 23 23 23 23 23 23 23 23 23 23 23 23 23 23 30
30 23 23 23 23 23 23 23 23 23 23 23 23 23 23 23 23 23 23 23 30 23 23 23 23 23 23 23 23 23 23 23 30 30 30 30 30 30 30 30 30 30 30 30 30 30 30 30 30 30
30 23 23 23 23 23 23 23 23 23 23 23 23 23 23 23 23 23 23 23 30 23 23 23 23 23 23 23 23 23 23 23 23 23 23 23 23 23 23 23 23 23 23 23 23 23 23 23 23 30
30 23 23 23 23 23 23 23 23 23 23 23 23 23 23 23 23 23 23 23 30 23 23 23 23 23 23 23 23 23 23 23 23 23 23 23 23 23 23 23 23 23 23 23 23 23 23 23 23 30
30 23 23 23 23 23 23 23 23 23 23 23 23 23 23 23 23 23 23 23 30 23 23 23 23 23 23 23 23 23 23 23 23 23 23 23 23 23 23 23 23 23 23 23 23 23 23 23 23 30
30 23 23 23 23 23 23 23 23 23 23 23 23 23 23 23 23 23 23 23 30 23 23 23 23 23 23 23 23 23 23 23 23 23 23 23 23 23 23 23 23 23 23 23 23 23 23 23 23 30
30 23 23 23 23 23 23 23 23 23 23 23 23 23 23 23 23 23 23 23 30 23 23 23 23 23 23 23 23 23 23 23 23 23 23 23 23 23 23 23 23 23 23 23 23 23 23 23 23 30
30 23 23 23 23 23 23 23 23 23 23 23 23 23 23 23 23 23 23 23 30 23 23 23 23 23 23 23 23 23 23 23 23 23 23 23 23 23 23 23 23 23 23 23 23 23 23 23 23 30
30 23 23 23 23 23 23 23 23 23 23 23 23 23 23 23 23 23 23 23 30 23 23 23 23 23 23 23 23 23 23 23 23 23 23 23 23 23 23 23 23 23 23 23 23 23 23 23 23 30
30 23 23 23 23 23 23 23 23 23 23 23 23 23 23 23 23 23 23 23 30 23 23 23 23 23 23 23 23 23 23 23 23 23 23 23 23 23 23 23 23 23 23 23 23 23 23 23 23 30
30 30 30 30 30 30 30 30 30 30 30 30 30 30 30 30 30 30 30 30 30 30 30 23 23 23 30 30 30 30 30 30 30 30 30 30 30 30 30 30 30 30 30 30 30 30 30 30 30 30