67 63 63 63 63 70 63 63 63 63 63 63 63 63 70 63 63 63 70 63 63 63 63 63 63 63 63 63 63 63 63 63 63 63 63 63 63 63 63 63 63 63 63 63 63 63 63 63 63 68
61 23 23 23 23 61 23 23 23 23 23 23 23 23 61 23 23 23 61 23 23 23 23 23 23 23 23 23 23 23 23 23 23 23 23 23 23 23 23 23 23 23 23 23 23 23 23 23 23 61
61 23 23 23 23 61 23 23 23 23 23 23 23 23 61 23 23 23 61 23 23 23 23 23 23 23 23 23 23 23 23 23 23 23 23 23 23 23 23 23 23 23 23 23 23 23 23 23 23 61
61 23 23 23 23 61 23 23 23 23 23 23 23 23 61 23 23 23 61 23 23 23 23 23 23 23 23 23 23 23 23 23 23 23 23 23 23 23 23 23 23 23 23 23 23 23 23 23 23 61
61 23 23 23 23 61 23 23 23 23 23 23 23 23 61 23 23 23 65 63 63 23 23 23 63 63 63 63 63 63 63 63 63 63 63 63 63 63 63 63 63 63 63 63 63 63 63 63 63 64
61 23 23 23 23 61 23 23 23 23 23 23 23 23 61 23 23 23 23 23 23 23 23 23 23 23 23 23 23 23 23 23 23 23 23 23 23 23 23 23 23 23 23 23 23 23 23 23 23 61
61 23 23 23 23 61 23 23 23 23 23 23 23 23 61 23 23 23 23 23 23 23 23 23 23 23 23 23 23 23 23 23 23 23 23 23 23 23 23 23 23 23 23 23 23 23 23 23 23 61
62 63 23 23 63 69 63 63 63 23 23 63 63 63 66 23 23 23 23 23 23 23 23 23 23 23 23 23 23 23 23 23 23 23 23 23 23 23 23 23 23 23 23 23 23 23 23 23 23 61
61 23 23 23 23 23 23 23 23 23 23 23 23 23 23 23 23 23 23 23 23 23 23 23 23 23 23 23 23 23 23 23 23 23 23 23 23 23 23 23 23 23 23 23 23 23 23 23 23 61
61 23 23 23 23 23 23 23 23 23 23 23 23 23 23 23 23 23 23 23 25 25 25 25 25 23 23 23 23 23 23 23 23 23 23 23 23 23 23 23 23 23 23 23 23 23 23 23 23 61
61 23 23 23 23 23 23 23 23 23 23 23 23 23 23 23 23 23 23 23 25 25 25 25 25 23 23 23 23 23 67 63 63 63 63 63 63 63 63 63 63 63 63 63 63 63 63 63 63 64
61 23 23 23 23 23 23 23 23 23 23 23 23 23 23 23 23 23 23 23 25 25 25 25 25 23 23 23 23 23 61 23 23 23 23 23 23 23 23 23 23 23 23 23 23 23 23 23 23 61
61 23 23 23 23 23 23 23 23 23 23 23 23 23 23 23 23 23 23 23 25 25 25 25 25 23 23 23 23 23 61 23 23 23 23 23 23 23 23 23 23 23 23 23 23 23 23 23 23 61
62 63 63 23 23 63 63 63 63 23 23 63 63 63 68 23 23 23 23 23 23 23 23 23 23 23 23 23 23 23 61 23 23 23 23 23 23 23 23 23 23 23 23 23 23 23 23 23 23 61
61 23 23 23 23 23 23 23 23 23 23 23 23 23 61 23 23 23 23 23 23 23 23 23 23 23 23 23 23 23 61 23 23 23 23 23 23 23 23 23 23 23 23 23 23 23 23 23 23 61
61 23 23 23 23 23 23 23 23 23 23 23 23 23 61 23 23 23 23 23 23 23 23 23 23 23 23 23 23 23 61 23 23 23 23 23 23 23 23 23 23 23 23 23 23 23 23 23 23 61
61 23 23 23 23 23 23 23 23 23 23 23 23 23 61 23 23 23 23 23 23 23 23 23 23 23 23 23 23 23 61 23 23 23 23 23 23 23 23 23 23 23 23 23 23 23 23 23 23 61
62 63 63 63 63 63 23 23 63 63 63 63 63 63 64 23 23 23 23 23 23 23 23 23 23 23 23 23 23 23 61 23 23 23 23 23 23 23 23 23 23 23 23 23 23 23 23 23 23 61
61 23 23 23 23 23 23 23 23 23 23 23 23 23 61 23 23 23 23 23 23 23 23 23 23 23 23 23 23 23 61 23 23 23 23 23 23 23 23 23 23 23 23 23 23 23 23 23 23 61
61 23 23 23 23 23 23 23 23 23 23 23 23 23 61 23 23 23 23 23 23 23 23 23 23 23 23 23 23 23 61 23 23 23 23 23 23 23 23 23 23 23 23 23 23 23 23 23 23 61
61 23 23 23 23 23 23 23 23 23 23 23 23 23 61 23 23 23 23 23 23 23 23 23 23 23 23 23 23 23 61 23 23 23 23 23 23 23 23 23 23 23 23 23 23 23 23 23 23 61
61 23 23 23 23 23 23 23 23 23 23 23 23 23 61 23 23 23 23 23 23 23 23 23 23 23 23 23 23 23 61 23 23 23 23 23 23 23 23 23 23 23 23 23 23 23 23 23 23 61
61 23 23 23 23 23 23 23 23 23 23 23 23 23 61 23 23 23 23 23 23 23 23 23 23 23 23 23 23 23 61 23 23 23 23 23 23 23 23 23 23 23 23 23 23 23 23 23 23 61
61 23 23 23 23 23 23 23 23 23 23 23 23 23 61 23 23 23 23 23 23 23 23 23 23 23 23 23 23 23 61 23 23 23 23 23 23 23 23 23 23 23 23 23 23 23 23 23 23 61
61 23 23 23 23 23 23 23 23 23 23 23 23 23 61 23 23 23 23 23 23 23 23 23 23 23 23 23 23 23 61 23 23 23 23 23 23 23 23 23 23 23 23 23 23 23 23 23 23 61
61 23 23 23 23 23 23 23 23 23 67 63 63 63 66 23 23 23 23 23 23 23 23 23 23 23 23 23 23 23 65 63 63 63 63 63 63 63 63 63 63 63 63 63 63 63 63 63 63 64
61 23 23 23 23 23 23 23 23 23 61 23 23 23 23 23 23 23 23 23 23 23 23 23 23 23 23 23 23 23 23 23 23 23 23 23 23 23 23 23 23 23 23 23 23 23 23 23 23 61
61 23 23 23 23 23 23 23 23 23 61 23 23 23 23 23 23 23 23 23 23 23 23 23 23 23 23 23 23 23 23 23 23 23 23 23 23 23 23 23 23 23 23 23 23 23 23 23 23 61
61 23 23 23 23 23 23 23 23 23 61 23 23 23 23 23 23 23 23 23 23 23 23 23 23 23 23 23 23 23 23 23 23 23 23 23 23 23 23 23 23 23 23 23 23 23 23 23 23 61
61 23 23 23 23 23 23 23 23 23 61 23 23 23 23 23 23 23 23 23 23 23 23 23 23 23 23 23 23 23 23 23 23 23 23 23 23 23 23 23 23 23 23 23 23 23 23 23 23 61
61 23 23 23 23 23 23 23 23 23 61 23 23 23 23 23 23 23 23 23 23 23 23 23 23 23 23 23 23 23 23 23 23 23 23 23 23 23 23 23 23 23 23 23 23 23 23 23 23 61
65 63 63 63 63 63 63 63 63 63 63 63 63 63 63 63 63 63 63 63 63 63 63 23 23 23 63 63 63 63 63 63 63 63 63 63 63 63 63 63 63 63 63 63 63 63 63 63 63 66