37 33 33 33 33 33 33 33 33 33 33 33 33 33 33 33 33 33 33 33 33 33 33 33 33 33 33 33 33 33 33 33 33 33 33 33 33 33 33 33 33 33 33 33 33 33 33 33 33 38
31 10 10 10 10 31 10 10 10 10 10 10 10 10 31 10 10 10 31 10 10 10 10 10 10 10 10 10 10 10 10 10 10 10 10 10 10 10 10 10 10 10 10 10 10 10 10 10 10 31
31 10 10 10 10 31 10 10 10 10 10 10 10 10 31 10 10 10 31 10 10 10 10 10 10 10 10 10 10 10 10 10 10 10 10 10 10 10 10 10 10 10 10 10 10 10 10 10 10 31
31 10 10 10 10 31 10 10 10 10 10 10 10 10 31 10 10 10 31 10 10 10 10 10 10 10 10 10 10 10 10 10 10 10 10 10 10 10 10 10 10 10 10 10 10 10 10 10 10 31
31 10 10 10 10 31 10 10 10 10 10 10 10 10 31 10 10 10 35 33 33 10 10 10 33 33 33 33 33 33 33 33 33 33 33 33 33 33 33 33 33 33 33 33 33 33 33 33 33 31
31 10 10 10 10 31 10 10 10 10 10 10 10 10 31 10 10 10 10 10 10 10 10 10 10 10 10 10 10 10 10 10 10 10 10 10 10 10 10 10 10 10 10 10 10 10 10 10 10 31
31 10 10 10 10 31 10 10 10 10 10 10 10 10 31 10 10 10 10 10 10 10 10 10 10 10 10 10 10 10 10 10 10 10 10 10 10 10 10 10 10 10 10 10 10 10 10 10 10 31
31 33 10 10 33 33 33 33 33 10 10 33 33 33 36 10 10 10 10 10 10 10 10 10 10 10 10 10 10 10 10 10 10 10 10 10 10 10 10 10 10 10 10 10 10 10 10 10 10 31
31 10 10 10 10 10 10 10 10 10 10 10 10 10 10 10 10 10 10 10 10 10 10 10 10 10 10 10 10 10 10 10 10 10 10 10 10 10 10 10 10 10 10 10 10 10 10 10 10 31
31 10 10 10 10 10 10 10 10 10 10 10 10 10 10 10 10 10 10 10 33 33 33 33 33 10 10 10 10 10 10 10 10 10 10 10 10 10 10 10 10 10 10 10 10 10 10 10 10 31
31 10 10 10 10 10 10 10 10 10 10 10 10 10 10 10 10 10 10 10 33 33 33 33 33 10 10 10 10 10 37 33 33 33 33 33 33 33 33 33 33 33 33 33 33 33 33 33 33 31
31 10 10 10 10 10 10 10 10 10 10 10 10 10 10 10 10 10 10 10 33 33 33 33 33 10 10 10 10 10 31 10 10 10 10 10 10 10 10 10 10 10 10 10 10 10 10 10 10 31
31 10 10 10 10 10 10 10 10 10 10 10 10 10 10 10 10 10 10 10 33 33 33 33 33 10 10 10 10 10 31 10 10 10 10 10 10 10 10 10 10 10 10 10 10 10 10 10 10 31
31 33 33 10 10 33 33 33 33 10 10 33 33 33 33 10 10 10 10 10 10 10 10 10 10 10 10 10 10 10 31 10 10 10 10 10 10 10 10 10 10 10 10 10 10 10 10 10 10 31
31 10 10 10 10 10 10 10 10 10 10 10 10 10 31 10 10 10 10 10 10 10 10 10 10 10 10 10 10 10 31 10 10 10 10 10 10 10 10 10 10 10 10 10 10 10 10 10 10 31
31 10 10 10 10 10 10 10 10 10 10 10 10 10 31 10 10 10 10 10 10 10 10 10 10 10 10 10 10 10 31 10 10 10 10 10 10 10 10 10 10 10 10 10 10 10 10 10 10 31
31 10 10 10 10 10 10 10 10 10 10 10 10 10 31 10 10 10 10 10 10 10 10 10 10 10 10 10 10 10 31 10 10 10 10 10 10 10 10 10 10 10 10 10 10 10 10 10 10 31
31 33 33 33 33 33 10 10 33 33 33 33 33 33 31 10 10 10 10 10 10 10 10 10 10 10 10 10 10 10 31 10 10 10 10 10 10 10 10 10 10 10 10 10 10 10 10 10 10 31
31 10 10 10 10 10 10 10 10 10 10 10 10 10 31 10 10 10 10 10 10 10 10 10 10 10 10 10 10 10 31 10 10 10 10 10 10 10 10 10 10 10 10 10 10 10 10 10 10 31
31 10 10 10 10 10 10 10 10 10 10 10 10 10 31 10 10 10 10 10 10 10 10 10 10 10 10 10 10 10 31 10 10 10 10 10 10 10 10 10 10 10 10 10 10 10 10 10 10 31
31 10 10 10 10 10 10 10 10 10 10 10 10 10 31 10 10 10 10 10 10 10 10 10 10 10 10 10 10 10 31 10 10 10 10 10 10 10 10 10 10 10 10 10 10 10 10 10 10 31
31 10 10 10 10 10 10 10 10 10 10 10 10 10 31 10 10 10 10 10 10 10 10 10 10 10 10 10 10 10 31 10 10 10 10 10 10 10 10 10 10 10 10 10 10 10 10 10 10 31
31 10 10 10 10 10 10 10 10 10 10 10 10 10 31 10 10 10 10 10 10 10 10 10 10 10 10 10 10 10 31 10 10 10 10 10 10 10 10 10 10 10 10 10 10 10 10 10 10 31
31 10 10 10 10 10 10 10 10 10 10 10 10 10 31 10 10 10 10 10 10 10 10 10 10 10 10 10 10 10 31 10 10 10 10 10 10 10 10 10 10 10 10 10 10 10 10 10 10 31
31 10 10 10 10 10 10 10 10 10 10 10 10 10 31 10 10 10 10 10 10 10 10 10 10 10 10 10 10 10 31 10 10 10 10 10 10 10 10 10 10 10 10 10 10 10 10 10 10 31
31 10 10 10 10 10 10 10 10 10 37 33 33 33 36 10 10 10 10 10 10 10 10 10 10 10 10 10 10 10 35 33 33 33 33 33 33 33 33 33 33 33 33 33 33 33 33 33 33 31
31 10 10 10 10 10 10 10 10 10 31 10 10 10 10 10 10 10 10 10 10 10 10 10 10 10 10 10 10 10 10 10 10 10 10 10 10 10 10 10 10 10 10 10 10 10 10 10 10 31
31 10 10 10 10 10 10 10 10 10 31 10 10 10 10 10 10 10 10 10 10 10 10 10 10 10 10 10 10 10 10 10 10 10 10 10 10 10 10 10 10 10 10 10 10 10 10 10 10 31
31 10 10 10 10 10 10 10 10 10 31 10 10 10 10 10 10 10 10 10 10 10 10 10 10 10 10 10 10 10 10 10 10 10 10 10 10 10 10 10 10 10 10 10 10 10 10 10 10 31
31 10 10 10 10 10 10 10 10 10 31 10 10 10 10 10 10 10 10 10 10 10 10 10 10 10 10 10 10 10 10 10 10 10 10 10 10 10 10 10 10 10 10 10 10 10 10 10 10 31
31 10 10 10 10 10 10 10 10 10 31 10 10 10 10 10 10 10 10 10 10 10 10 10 10 10 10 10 10 10 10 10 10 10 10 10 10 10 10 10 10 10 10 10 10 10 10 10 10 31
35 33 33 33 33 33 33 33 33 33 33 33 33 33 33 33 33 33 33 33 33 33 33 10 10 10 33 33 33 33 33 33 33 33 33 33 33 33 33 33 33 33 33 33 33 33 33 33 33 36