37 33 33 33 33 33 33 33 33 33 33 33 33 33 33 33 33 33 33 33 33 33 33 33 33 33 33 33 33 33 33 33 33 33 33 33 33 33 33 33 33 33 33 33 33 33 33 33 33 33 33 33 33 33 33 33 33 33 33 33 33 33 33 33 33 33 33 38
31 25 25 25 25 25 25 25 25 25 25 25 25 25 25 25 25 25 25 25 25 25 25 25 25 25 25 25 25 25 25 25 25 25 25 25 25 25 25 25 25 25 25 25 25 25 25 25 25 25 25 25 25 25 25 25 25 25 25 25 25 25 25 25 25 25 25 31
31 25 25 25 25 25 25 25 25 25 25 25 25 25 25 25 25 25 25 25 25 25 25 25 25 25 25 25 25 25 25 25 25 25 25 25 25 25 25 25 25 25 25 25 25 25 25 25 25 25 25 25 25 25 25 25 25 25 25 25 25 25 25 25 25 25 25 31
31 25 25 25 25 25 25 25 25 25 25 25 25 25 25 25 25 25 25 25 25 25 25 25 25 25 25 25 25 25 25 25 25 25 25 25 25 25 25 25 25 25 25 25 25 25 25 25 25 25 25 25 25 25 25 25 25 25 25 25 25 25 25 25 25 25 25 31
31 25 25 25 25 25 25 25 25 25 25 25 25 25 25 25 25 25 25 25 25 25 25 25 25 25 25 25 25 25 25 25 25 25 25 25 25 25 25 25 25 25 25 25 25 25 25 25 25 25 25 25 25 25 25 25 25 25 25 25 25 25 25 25 25 25 25 31
31 25 25 25 25 25 25 25 25 25 25 25 25 25 25 25 25 25 25 25 25 25 25 25 25 25 25 25 25 25 25 25 25 25 25 25 25 25 25 25 25 25 25 25 25 25 25 25 25 25 25 25 25 25 25 25 25 25 25 25 25 25 25 25 25 25 25 31
31 25 25 25 25 25 25 25 25 25 25 25 25 25 25 25 25 25 25 25 25 25 25 25 25 25 25 25 25 25 25 25 25 25 25 25 25 25 25 25 25 25 25 25 25 25 25 25 25 25 25 25 25 25 25 25 25 25 25 25 25 25 25 25 25 25 25 31
31 25 25 25 25 25 25 25 25 25 25 25 25 25 25 25 25 25 25 25 25 25 25 25 25 25 25 25 25 25 25 25 25 25 25 25 25 25 25 25 25 25 25 25 25 25 25 25 25 25 25 25 25 25 25 25 25 25 25 25 25 25 25 25 25 25 25 31
31 25 25 25 25 25 25 25 25 25 25 25 25 25 25 25 25 25 25 25 25 25 25 25 25 25 25 25 25 25 25 25 25 25 25 25 25 25 25 25 25 25 25 25 25 25 25 25 25 25 25 25 25 25 25 25 25 25 25 25 25 25 25 25 25 25 25 31
31 25 25 25 25 25 25 25 25 25 25 25 25 25 25 25 25 25 25 25 25 25 25 25 25 25 25 25 25 25 25 25 25 25 25 25 25 25 25 25 25 25 25 25 25 25 25 25 25 25 25 25 25 25 25 25 25 25 25 25 25 25 25 25 25 25 25 31
31 25 25 25 25 25 25 25 25 25 25 25 25 25 25 25 25 25 25 25 25 25 25 25 25 25 25 25 25 25 25 25 25 25 25 25 25 25 25 25 25 25 25 25 25 25 25 25 25 25 25 25 25 25 25 25 25 25 25 25 25 25 25 25 25 25 25 31
31 25 25 25 25 25 25 25 25 25 25 25 25 25 25 25 25 25 25 25 25 25 25 25 25 25 25 25 25 25 25 25 25 25 25 25 25 25 25 25 25 25 25 25 25 25 25 25 25 25 25 25 25 25 25 25 25 25 25 25 25 25 25 25 25 25 25 31
31 25 25 25 25 25 25 25 25 25 25 25 25 25 25 25 25 25 25 25 25 25 25 25 25 25 25 25 25 25 25 25 25 25 25 25 25 25 25 25 25 25 25 25 25 25 25 25 25 25 25 25 25 25 25 25 25 25 25 25 25 25 25 25 25 25 25 31
31 25 25 25 25 25 25 25 25 25 25 25 25 25 25 25 25 25 25 25 25 25 25 25 25 25 25 25 25 25 25 25 25 25 25 25 25 25 25 25 25 25 25 25 25 25 25 25 25 25 25 25 25 25 25 25 25 25 25 25 25 25 25 25 25 25 25 31
31 25 25 25 25 25 25 25 25 25 25 25 25 25 25 25 25 25 25 25 25 25 25 25 25 25 25 25 25 25 25 25 25 25 25 25 25 25 25 25 25 25 25 25 25 25 25 25 25 25 25 25 25 25 25 25 25 25 25 25 25 25 25 25 25 25 25 31
31 25 25 25 25 25 25 25 25 25 25 25 25 25 25 25 25 25 25 25 25 25 25 25 25 25 25 25 25 25 25 25 25 25 25 25 25 25 25 25 25 25 25 25 25 25 25 25 25 25 25 25 25 25 25 25 25 25 25 25 25 25 25 25 25 25 25 31
31 25 25 25 25 25 25 25 25 25 25 25 25 25 25 25 25 25 25 25 25 25 25 25 25 25 25 25 25 25 25 25 25 25 25 25 25 25 25 25 25 25 25 25 25 25 25 25 25 25 25 25 25 25 25 25 25 25 25 25 25 25 25 25 25 25 25 31
31 25 25 25 25 25 25 25 25 25 25 25 25 25 25 25 25 25 25 25 25 25 25 25 25 25 25 25 25 25 25 25 25 25 25 25 25 25 25 25 25 25 25 25 25 25 25 25 25 25 25 25 25 25 25 25 25 25 25 25 25 25 25 25 25 25 25 31
31 25 25 25 25 25 25 25 25 25 25 25 25 25 25 25 25 25 25 25 25 25 25 25 25 25 25 25 25 25 25 25 25 25 25 25 25 25 25 25 25 25 25 25 25 25 25 25 25 25 25 25 25 25 25 25 25 25 25 25 25 25 25 25 25 25 25 31
31 25 25 25 25 25 25 25 25 25 25 25 25 25 25 25 25 25 25 25 25 25 25 25 25 25 25 25 25 25 25 25 25 25 25 25 25 25 25 25 25 25 25 25 25 25 25 25 25 25 25 25 25 25 25 25 25 25 25 25 25 25 25 25 25 25 25 31
31 25 25 25 25 25 25 25 25 25 25 25 25 25 25 25 25 25 25 25 25 25 25 25 25 25 25 25 25 25 25 25 25 25 25 25 25 25 25 25 25 25 25 25 25 25 25 25 25 25 25 25 25 25 25 25 25 25 25 25 25 25 25 25 25 25 25 31
32 33 33 33 33 33 33 33 33 33 40 33 33 33 33 33 33 40 33 33 33 33 33 33 33 33 33 33 33 33 33 33 33 33 33 33 33 33 25 25 25 33 33 33 33 33 33 33 33 33 33 33 33 33 33 33 33 40 33 33 33 33 33 33 33 33 33 31
31 25 25 25 25 25 25 25 25 25 31 25 25 25 25 25 25 31 25 25 25 25 25 25 25 25 25 25 25 25 25 25 25 25 25 25 25 25 25 25 25 25 25 25 25 25 25 25 25 25 25 25 25 25 25 25 25 31 25 25 25 25 25 25 25 25 25 31
31 25 25 25 25 25 25 25 25 25 31 25 25 25 25 25 25 31 25 25 25 25 25 25 25 25 25 25 25 25 25 25 25 25 25 25 25 25 25 25 25 25 25 25 25 25 25 25 25 25 25 25 25 25 25 25 25 31 25 25 25 25 25 25 25 25 25 31
31 25 25 25 25 25 25 25 25 25 25 25 25 25 25 25 25 31 25 25 25 25 25 25 25 25 25 25 25 25 25 25 25 25 25 25 25 25 25 25 25 25 25 25 25 25 25 25 25 25 25 25 25 25 25 25 25 31 25 25 25 25 25 25 25 25 25 31
31 25 25 25 25 25 25 25 25 25 25 25 25 25 25 25 25 31 25 25 25 25 25 25 25 25 25 25 25 25 25 25 25 25 25 25 25 25 25 25 25 25 25 25 25 25 25 25 25 25 25 25 25 25 25 25 25 31 25 25 25 25 25 25 25 25 25 31
31 25 25 25 25 25 25 25 25 25 31 25 25 25 25 25 25 31 25 25 25 25 25 25 25 25 25 25 25 25 25 25 25 25 25 25 25 25 25 25 25 25 25 25 25 25 25 25 25 25 25 25 25 25 25 25 25 31 25 25 25 25 25 25 25 25 25 31
31 25 25 25 25 25 25 25 25 25 31 25 25 25 25 25 25 31 25 25 25 25 25 55 55 55 55 55 55 55 55 55 55 55 55 55 55 55 55 55 55 55 55 55 55 55 55 55 55 55 55 55 55 55 55 25 25 31 25 25 25 25 25 25 25 25 25 31
31 25 25 25 25 25 25 25 25 25 31 25 25 25 25 25 25 31 25 25 25 25 25 55 25 25 25 25 25 25 25 25 25 25 25 55 25 25 25 25 25 25 25 55 25 25 25 25 25 25 25 25 25 25 55 25 25 31 25 25 25 25 25 25 25 25 25 31
31 25 25 25 25 25 25 25 25 25 31 25 25 25 25 25 25 31 25 25 25 25 25 55 25 25 25 25 25 25 25 25 25 25 25 55 25 25 25 25 25 25 25 55 25 25 25 25 25 25 25 25 25 25 55 25 25 31 25 25 25 25 25 25 25 25 25 31
31 25 25 25 25 25 25 25 25 25 31 25 25 25 25 25 25 31 25 25 25 25 25 55 25 25 55 25 25 25 25 55 55 25 25 55 55 55 25 25 55 25 25 25 25 25 55 25 25 25 25 55 25 25 55 25 25 31 25 25 25 25 25 25 25 25 25 31
31 25 25 25 25 25 25 25 25 25 31 25 25 25 25 25 25 31 25 25 25 25 25 55 25 25 55 25 25 25 25 55 25 25 25 55 25 25 25 25 55 25 25 25 25 25 55 25 25 25 25 55 25 25 55 25 25 31 25 25 25 25 25 25 25 25 25 31
31 25 25 25 25 25 25 25 25 25 31 25 25 25 25 25 25 31 25 25 25 25 25 55 25 25 55 25 25 25 25 55 25 25 25 55 25 25 25 25 55 55 55 25 25 55 55 25 25 55 55 55 25 25 55 25 25 31 25 25 25 25 25 25 25 25 25 31
31 25 25 25 25 25 25 25 25 25 31 25 25 25 25 25 25 31 25 25 25 25 25 55 25 25 55 25 25 25 25 55 25 25 55 55 25 25 55 55 55 25 25 25 25 55 25 25 25 25 25 55 25 25 55 25 25 31 25 25 25 25 25 25 25 25 25 31
31 25 25 25 25 25 25 25 25 25 31 25 25 25 25 25 25 31 25 25 25 25 25 55 25 25 55 25 25 25 25 55 25 25 55 25 25 25 25 25 55 25 25 25 25 55 25 25 25 25 25 55 25 25 55 25 25 31 25 25 25 25 25 25 25 25 25 31
32 33 33 33 33 33 38 25 25 25 31 25 25 25 25 25 25 31 25 25 25 25 25 55 25 25 55 25 25 25 25 55 25 25 55 25 25 25 25 25 55 25 25 55 55 55 25 25 55 25 25 55 25 25 55 25 25 31 25 25 25 25 25 25 25 25 25 31
31 25 25 25 25 25 31 25 25 25 35 33 33 33 33 33 33 36 25 25 25 25 25 55 25 25 55 25 25 25 25 55 25 25 25 25 25 55 25 25 55 25 25 25 25 55 25 25 55 25 25 55 25 25 55 25 25 31 25 25 25 25 25 25 25 25 25 31
31 25 25 25 25 25 31 25 25 25 25 25 25 25 25 25 25 25 25 25 25 25 25 55 25 25 55 25 25 25 25 55 25 25 25 25 25 55 25 25 55 25 25 25 25 55 25 25 55 25 25 55 25 25 55 25 25 25 25 25 25 25 25 25 25 25 25 31
31 25 25 25 25 25 31 25 25 25 25 25 25 25 25 25 25 25 25 25 25 25 25 55 25 25 55 55 55 55 55 55 55 55 55 55 55 55 25 25 55 55 55 25 25 55 25 25 55 25 25 55 25 25 25 25 25 25 25 25 25 25 25 25 25 25 25 31
31 25 25 25 25 25 31 25 25 25 25 25 25 25 25 25 25 25 25 25 25 25 25 55 25 25 25 25 25 25 25 25 25 25 25 55 25 25 25 25 55 25 25 25 25 55 25 25 55 25 25 55 25 25 25 25 25 25 25 25 25 25 25 25 25 25 25 31
31 25 25 25 25 25 31 25 25 25 37 33 33 33 33 33 33 38 25 25 25 25 25 55 25 25 25 25 25 25 25 25 25 25 25 55 25 25 25 25 55 25 25 25 25 55 25 25 55 25 25 55 25 25 55 25 25 31 25 25 25 25 25 25 25 25 25 31
31 25 25 25 25 25 31 25 25 25 31 25 25 25 25 25 25 31 25 25 25 25 25 55 25 25 55 55 55 55 25 25 55 25 25 55 25 25 55 55 55 25 25 55 55 55 25 25 55 25 25 55 25 25 55 25 25 31 25 25 25 25 25 25 25 25 25 31
32 33 33 33 33 33 36 25 25 25 31 25 25 25 25 25 25 31 25 25 25 25 25 55 25 25 55 25 25 55 25 25 55 25 25 55 25 25 25 25 55 25 25 25 25 25 25 25 55 25 25 55 25 25 55 25 25 31 25 25 25 25 25 25 25 25 25 31
31 25 25 25 25 25 25 25 25 25 31 25 25 25 25 25 25 31 25 25 25 25 25 55 25 25 55 25 25 55 25 25 55 25 25 55 25 25 25 25 55 25 25 25 25 25 25 25 55 25 25 55 25 25 55 25 25 31 25 25 25 25 25 25 25 25 25 31
31 25 25 25 25 25 25 25 25 25 31 25 25 25 25 25 25 31 25 25 25 25 25 55 25 25 55 25 25 55 25 25 55 25 25 55 25 25 25 25 55 55 55 55 55 55 25 25 55 25 25 55 25 25 55 25 25 31 25 25 25 25 25 25 25 25 25 31
31 25 25 25 25 25 25 25 25 25 31 25 25 25 25 25 25 31 25 25 25 25 25 55 25 25 55 25 25 55 25 25 55 25 25 55 55 55 25 25 25 25 25 25 25 25 25 25 55 25 25 25 25 25 55 25 25 31 25 25 25 25 25 25 25 25 25 31
31 25 25 25 25 25 25 25 25 25 31 25 25 25 25 25 25 31 25 25 25 25 25 55 25 25 55 25 25 55 25 25 55 25 25 55 25 25 25 25 25 25 25 25 25 25 25 25 55 25 25 25 25 25 55 25 25 31 25 25 25 25 25 25 25 25 25 31
31 25 25 25 25 25 25 25 25 25 31 25 25 25 25 25 25 31 25 25 25 25 25 55 25 25 55 25 25 55 55 55 55 25 25 55 25 25 25 25 55 55 55 55 55 55 55 55 55 55 55 55 55 55 55 25 25 31 25 25 25 25 25 25 25 25 25 31
31 25 25 25 25 25 25 25 25 25 31 25 25 25 25 25 25 31 25 25 25 25 25 25 25 25 25 25 25 25 25 25 25 25 25 55 25 25 25 25 25 25 25 25 25 25 25 25 25 25 25 25 25 25 25 25 25 31 25 25 25 25 25 25 25 25 25 31
31 25 25 25 25 25 25 25 25 25 31 25 25 25 25 25 25 31 25 25 25 25 25 25 25 25 25 25 25 25 25 25 25 25 25 55 25 25 25 25 25 25 25 25 25 25 25 25 25 25 25 25 25 25 25 25 25 31 25 25 25 25 25 25 25 25 25 31
35 33 25 25 33 33 33 25 25 33 39 33 33 33 33 33 33 39 33 33 33 33 33 33 33 33 33 33 33 33 33 33 33 33 33 33 33 33 33 33 33 33 33 33 33 33 33 33 33 33 33 33 33 33 33 33 33 39 33 33 33 33 33 33 33 33 33 36