67 63 63 63 63 63 63 63 63 63 63 63 63 63 63 63 63 63 63 63 63 70 63 63 23 23 23 63 63 70 63 63 63 63 63 63 63 63 63 63 63 63 63 63 63 63 63 63 63 68
61 23 23 23 23 23 23 23 23 23 23 23 23 23 23 23 23 23 23 23 23 61 23 23 23 23 23 23 23 61 23 23 23 23 23 23 23 23 23 23 23 23 23 23 23 23 23 23 23 61
61 23 23 23 23 23 23 23 23 23 23 23 23 23 23 23 23 23 23 23 23 61 23 23 23 23 23 23 23 61 23 23 23 23 23 23 23 23 23 23 23 23 23 23 23 23 23 23 23 61
61 53 53 53 53 53 53 53 53 23 23 23 53 53 53 53 53 53 53 53 53 61 23 23 23 23 23 23 23 65 63 63 63 63 63 63 63 63 63 63 63 63 63 63 63 63 63 63 63 64
61 54 54 54 54 54 54 54 54 23 23 23 54 54 54 54 54 54 54 54 54 61 23 23 23 23 23 23 23 23 23 23 23 23 23 23 23 23 23 23 23 23 23 23 23 23 23 23 23 61
61 54 54 54 54 54 54 54 54 23 23 23 54 54 54 54 54 54 54 54 54 61 23 23 23 23 23 23 23 23 23 23 23 23 23 23 23 23 23 23 23 23 23 23 23 23 23 23 23 61
61 53 53 53 53 53 53 53 53 23 23 23 53 53 53 53 53 53 53 53 53 61 23 23 23 23 23 23 23 23 23 23 23 23 23 23 23 23 23 23 23 23 23 23 23 23 23 23 23 61
61 23 23 23 23 23 23 23 23 23 23 23 23 23 23 23 23 23 23 23 23 61 23 23 23 23 23 23 23 23 23 23 23 23 23 23 23 23 23 23 23 23 23 23 23 23 23 23 23 61
61 23 23 23 23 23 23 23 23 23 23 23 23 23 23 23 23 23 23 23 23 61 23 23 23 23 23 23 23 23 23 23 23 23 23 23 23 23 23 23 23 23 23 23 23 23 23 23 23 61
61 53 53 53 53 53 53 53 53 23 23 23 53 53 53 53 53 53 53 53 53 65 63 63 63 63 63 63 63 63 63 63 63 63 63 70 63 63 63 23 23 23 23 23 23 23 63 63 63 64
61 54 54 54 54 54 54 54 54 23 23 23 54 54 54 54 54 54 54 54 54 23 23 23 23 23 23 23 23 23 23 23 23 23 23 61 23 23 23 23 23 23 23 23 23 23 23 23 23 61
61 54 54 54 54 54 54 54 54 23 23 23 54 54 54 54 54 54 54 54 54 23 23 23 23 23 23 23 23 23 23 23 23 23 23 61 23 23 23 23 23 23 23 23 23 23 23 23 23 61
61 53 53 53 53 53 53 53 53 23 23 23 53 53 53 53 53 53 53 53 53 23 23 23 23 23 23 23 23 23 23 23 23 23 23 61 23 23 23 23 23 23 61 23 23 23 23 23 23 61
61 23 23 23 23 23 23 23 23 23 23 23 23 23 23 23 23 23 23 23 23 23 23 23 23 23 23 23 23 23 23 23 23 23 23 61 23 23 23 23 23 23 61 23 23 23 23 23 23 61
61 23 23 23 23 23 23 23 23 23 23 23 23 23 23 23 23 23 23 23 23 23 23 23 23 23 23 23 23 23 23 23 23 23 23 61 23 23 23 23 23 23 61 23 23 23 23 23 23 61
61 53 53 53 53 53 53 53 53 23 23 23 53 53 53 53 53 53 53 53 53 23 23 23 23 23 23 23 23 23 23 23 23 23 23 61 23 23 23 23 23 23 61 23 23 23 23 23 23 61
61 54 54 54 54 54 54 54 54 23 23 23 54 54 54 54 54 54 54 54 54 23 23 23 23 23 23 23 23 23 23 23 23 23 23 61 23 23 23 23 23 23 61 23 23 23 23 23 23 61
61 54 54 54 54 54 54 54 54 23 23 23 54 54 54 54 54 54 54 54 54 23 23 23 23 23 23 23 23 23 23 23 23 23 23 61 23 23 23 23 23 23 61 23 23 23 23 23 23 61
61 53 53 53 53 53 53 53 53 23 23 23 53 53 53 53 53 53 53 53 53 23 23 23 23 23 23 23 23 23 23 23 23 23 23 61 23 23 23 23 23 23 61 23 23 23 23 23 23 61
61 23 23 23 23 23 23 23 23 23 23 23 23 23 23 23 23 23 23 23 23 23 23 23 23 23 23 23 23 23 23 23 23 23 23 61 23 23 23 23 23 23 61 23 23 23 23 23 23 61
61 23 23 23 23 23 23 23 23 23 23 23 23 23 23 23 23 23 23 23 23 23 23 23 23 23 23 23 23 23 23 23 23 23 23 61 23 23 23 23 23 23 61 23 23 23 23 23 23 61
61 53 53 53 53 53 53 53 53 23 23 23 53 53 53 53 53 53 53 53 53 23 23 23 23 23 23 23 23 23 23 23 23 23 23 61 23 23 23 23 23 23 61 23 23 23 23 23 23 61
61 54 54 54 54 54 54 54 54 23 23 23 54 54 54 54 54 54 54 54 54 23 23 23 23 23 23 23 23 23 23 23 23 23 23 61 23 23 23 23 23 23 61 23 23 23 23 23 23 61
61 54 54 54 54 54 54 54 54 23 23 23 54 54 54 54 54 54 54 54 54 23 23 23 23 23 23 23 23 23 23 23 23 23 23 61 23 23 23 23 23 23 61 23 23 23 23 23 23 61
61 53 53 53 53 53 53 53 53 23 23 23 53 53 53 53 53 53 53 53 53 23 23 23 23 23 23 23 23 23 23 23 23 23 23 61 23 23 23 23 23 23 61 23 23 23 23 23 23 61
61 23 23 23 23 23 23 23 23 23 23 23 23 23 23 23 23 23 23 23 23 23 23 23 23 23 23 23 23 23 23 23 23 23 23 61 23 23 23 23 23 23 61 23 23 23 23 23 23 61
61 23 23 23 23 23 23 23 23 23 23 23 23 23 23 23 23 23 23 23 23 23 23 23 23 23 23 23 23 23 23 23 23 23 23 61 23 23 23 23 23 23 61 23 23 23 23 23 23 61
61 53 53 53 53 53 53 53 53 23 23 23 53 53 53 53 53 53 53 53 53 23 23 23 23 23 23 23 23 23 23 23 23 23 23 61 23 23 23 23 23 23 61 23 23 23 23 23 23 61
61 54 54 54 54 54 54 54 54 23 23 23 54 54 54 54 54 54 54 54 54 23 23 23 23 23 23 23 23 23 23 23 23 23 23 61 23 23 23 23 23 23 61 23 23 23 23 23 23 61
61 54 54 54 54 54 54 54 54 23 23 23 54 54 54 54 54 54 54 54 54 23 23 23 23 23 23 23 23 23 23 23 23 23 23 61 23 23 23 23 23 23 61 23 23 23 23 23 23 61
61 53 53 53 53 53 53 53 53 23 23 23 53 53 53 53 53 53 53 53 53 23 23 23 23 23 23 23 23 23 23 23 23 23 23 61 23 23 23 23 23 23 61 23 23 23 23 23 23 61
61 23 23 23 23 23 23 23 23 23 23 23 23 23 23 23 23 23 23 23 23 23 23 23 23 23 23 23 23 23 23 23 23 23 23 61 23 23 23 23 23 23 23 23 23 23 23 23 23 61
61 23 23 23 23 23 23 23 23 23 23 23 23 23 23 23 23 23 23 23 23 23 23 23 23 23 23 23 23 23 23 23 23 23 23 61 23 23 23 23 23 23 23 23 23 23 23 23 23 61
61 53 53 53 53 53 53 53 53 23 23 23 23 23 23 23 23 23 23 23 23 23 23 23 23 23 23 23 23 23 23 23 23 23 23 65 63 63 23 23 23 23 23 23 23 23 23 23 23 61
61 54 54 54 54 54 54 54 54 23 23 23 23 23 23 23 23 23 23 23 23 23 23 23 23 23 23 23 23 23 23 23 23 23 23 23 23 23 23 23 23 23 23 23 23 23 23 23 23 61
61 54 54 54 54 54 54 54 54 23 23 23 23 23 23 23 23 23 23 23 23 23 23 23 23 23 23 23 23 23 23 23 23 23 23 23 23 23 23 23 23 23 23 23 23 23 23 23 23 61
61 53 53 53 53 53 53 53 53 23 23 23 23 23 23 23 23 23 23 23 23 23 23 23 23 23 23 23 23 23 23 23 23 23 23 23 23 23 23 23 23 23 23 23 23 23 23 23 23 61
61 23 23 23 23 23 23 23 23 23 23 23 23 23 23 23 23 23 23 23 23 23 23 23 23 23 23 23 23 67 63 63 63 63 68 23 23 23 23 23 23 23 23 23 23 23 23 23 23 61
61 53 53 53 53 53 53 53 53 23 23 23 23 23 23 23 23 23 23 23 23 23 23 23 23 23 23 23 23 61 23 23 23 23 61 23 23 23 23 23 23 23 23 23 23 23 23 23 23 61
61 23 23 23 23 23 23 23 23 23 23 23 23 23 23 23 23 23 23 23 23 23 23 23 23 23 23 23 23 61 23 23 23 23 61 23 23 23 23 23 23 23 23 23 23 23 23 23 23 61
61 54 54 54 54 54 54 54 54 23 23 23 23 23 23 23 23 23 23 23 23 23 23 23 23 23 23 23 23 61 23 23 23 23 61 23 23 23 23 23 23 23 23 23 23 23 23 23 23 61
61 54 54 54 54 54 54 54 54 23 23 23 23 23 23 23 23 23 23 23 23 23 23 23 23 23 23 23 23 65 63 63 63 63 66 23 23 23 23 23 23 23 23 23 23 23 23 23 23 61
61 53 53 53 53 53 53 53 53 23 23 23 23 23 23 23 23 23 23 23 23 23 23 23 23 23 23 23 23 23 23 23 23 23 23 23 23 23 23 23 23 23 23 23 23 23 23 23 23 61
61 23 23 23 23 23 23 23 23 23 23 23 23 23 23 23 23 23 23 23 23 23 23 23 23 23 23 23 23 23 23 23 23 23 23 23 23 23 23 23 23 23 23 23 23 23 23 23 23 61
61 23 23 23 23 23 23 23 23 23 23 23 23 23 23 23 23 23 23 23 23 23 23 23 23 23 23 23 23 23 23 23 23 23 23 23 23 23 23 23 23 23 23 23 23 23 23 23 23 61
23 23 23 23 23 23 23 23 23 23 23 23 23 23 23 23 23 23 23 23 23 23 23 23 23 23 23 23 23 23 23 23 23 23 23 23 23 23 23 23 23 23 23 23 23 23 23 23 23 61
23 23 23 23 23 23 23 23 23 23 23 23 23 23 23 23 23 23 23 23 23 23 23 23 23 23 23 23 23 23 23 23 23 23 23 23 23 23 23 23 23 23 23 23 23 23 23 23 23 61
23 23 23 23 23 23 23 23 23 23 23 23 23 23 23 23 23 23 23 23 23 23 23 23 23 23 23 23 23 23 23 23 23 23 23 23 23 23 23 23 23 23 23 23 23 23 23 23 23 61
61 23 23 23 23 23 23 23 23 23 23 23 23 23 23 23 23 23 23 23 23 23 23 23 23 23 23 23 23 23 23 23 23 23 23 23 23 23 23 23 23 23 23 23 23 23 23 23 23 61
65 63 63 63 63 63 63 63 63 63 63 63 63 63 63 63 63 63 63 63 63 63 63 63 63 63 63 63 63 63 63 63 63 63 63 63 63 63 63 63 63 63 63 63 63 63 63 63 63 66