33 33 33 33 33 33 33 33 33 33 33 33 33 33 33 33 33 33 33 33 33 33 33 33 23 23 23 33 33 33 33 33 33 33 33 33 33 33 33 33 33 33 33 33 33 33 33 33 33 33
31 23 23 23 23 23 23 23 23 23 23 23 23 23 23 23 23 23 23 23 23 31 23 23 23 23 23 23 23 31 23 23 23 23 23 23 23 23 23 23 23 23 23 23 23 23 23 23 23 31
31 23 23 23 23 23 23 23 23 23 23 23 23 23 23 23 23 23 23 23 23 31 23 23 23 23 23 23 23 31 23 23 23 23 23 23 23 23 23 23 23 23 23 23 23 23 23 23 23 31
31 53 53 53 53 53 53 53 53 23 23 23 53 53 53 53 53 53 53 53 53 31 23 23 23 23 23 23 23 30 30 30 30 30 30 30 30 30 30 30 30 30 30 30 30 30 30 30 30 31
31 54 54 54 54 54 54 54 54 23 23 23 54 54 54 54 54 54 54 54 54 31 23 23 23 23 23 23 23 23 23 23 23 23 23 23 23 23 23 23 23 23 23 23 23 23 23 23 23 31
31 54 54 54 54 54 54 54 54 23 23 23 54 54 54 54 54 54 54 54 54 31 23 23 23 23 23 23 23 23 23 23 23 23 23 23 23 23 23 23 23 23 23 23 23 23 23 23 23 31
31 53 53 53 53 53 53 53 53 23 23 23 53 53 53 53 53 53 53 53 53 31 23 23 23 23 23 23 23 23 23 23 23 23 23 23 23 23 23 23 23 23 23 23 23 23 23 23 23 31
31 23 23 23 23 23 23 23 23 23 23 23 23 23 23 23 23 23 23 23 23 31 23 23 23 23 23 23 23 23 23 23 23 23 23 23 23 23 23 23 23 23 23 23 23 23 23 23 23 31
31 23 23 23 23 23 23 23 23 23 23 23 23 23 23 23 23 23 23 23 23 31 23 23 23 23 23 23 23 23 23 23 23 23 23 23 23 23 23 23 23 23 23 23 23 23 23 23 23 31
31 53 53 53 53 53 53 53 53 23 23 23 53 53 53 53 53 53 53 53 53 30 30 30 30 30 30 30 30 30 30 30 30 30 30 30 31 31 31 23 23 23 31 23 23 23 31 31 31 31
31 54 54 54 54 54 54 54 54 23 23 23 54 54 54 54 54 54 54 54 54 23 23 23 23 23 23 23 23 23 23 23 23 23 23 31 23 23 23 23 23 23 31 23 23 23 23 23 23 31
31 54 54 54 54 54 54 54 54 23 23 23 54 54 54 54 54 54 54 54 54 23 23 23 23 23 23 23 23 23 23 23 23 23 23 31 23 23 23 23 23 23 31 23 23 23 23 23 23 31
31 53 53 53 53 53 53 53 53 23 23 23 53 53 53 53 53 53 53 53 53 23 23 23 23 23 23 23 23 23 23 23 23 23 23 31 23 23 23 23 23 23 31 23 23 23 23 23 23 31
31 23 23 23 23 23 23 23 23 23 23 23 23 23 23 23 23 23 23 23 23 23 23 23 23 23 23 23 23 23 23 23 23 23 23 31 23 23 23 23 23 23 31 23 23 23 23 23 23 31
31 23 23 23 23 23 23 23 23 23 23 23 23 23 23 23 23 23 23 23 23 23 23 23 23 23 23 23 23 23 23 23 23 23 23 31 23 23 23 23 23 23 31 23 23 23 23 23 23 31
31 53 53 53 53 53 53 53 53 23 23 23 53 53 53 53 53 53 53 53 53 23 23 23 23 23 23 23 23 23 23 23 23 23 23 31 23 23 23 23 23 23 31 23 23 23 23 23 23 31
31 54 54 54 54 54 54 54 54 23 23 23 54 54 54 54 54 54 54 54 54 23 23 23 23 23 23 23 23 23 23 23 23 23 23 31 23 23 23 23 23 23 31 23 23 23 23 23 23 31
31 54 54 54 54 54 54 54 54 23 23 23 54 54 54 54 54 54 54 54 54 23 23 23 23 23 23 23 23 23 23 23 23 23 23 31 23 23 23 23 23 23 31 23 23 23 23 23 23 31
31 53 53 53 53 53 53 53 53 23 23 23 53 53 53 53 53 53 53 53 53 23 23 23 23 23 23 23 23 23 23 23 23 23 23 31 23 23 23 23 23 23 31 23 23 23 23 23 23 31
31 23 23 23 23 23 23 23 23 23 23 23 23 23 23 23 23 23 23 23 23 23 23 23 23 23 23 23 23 23 23 23 23 23 23 31 23 23 23 23 23 23 31 23 23 23 23 23 23 31
31 23 23 23 23 23 23 23 23 23 23 23 23 23 23 23 23 23 23 23 23 23 23 23 23 23 23 23 23 23 23 23 23 23 23 31 23 23 23 23 23 23 31 23 23 23 23 23 23 31
31 53 53 53 53 53 53 53 53 23 23 23 53 53 53 53 53 53 53 53 53 23 23 23 23 23 23 23 23 23 23 23 23 23 23 31 23 23 23 23 23 23 31 23 23 23 23 23 23 31
31 54 54 54 54 54 54 54 54 23 23 23 54 54 54 54 54 54 54 54 54 23 23 23 23 23 23 23 23 23 23 23 23 23 23 31 23 23 23 23 23 23 31 23 23 23 23 23 23 31
31 54 54 54 54 54 54 54 54 23 23 23 54 54 54 54 54 54 54 54 54 23 23 23 23 23 23 23 23 23 23 23 23 23 23 31 23 23 23 23 23 23 31 23 23 23 23 23 23 31
31 53 53 53 53 53 53 53 53 23 23 23 53 53 53 53 53 53 53 53 53 23 23 23 23 23 23 23 23 23 23 23 23 23 23 31 23 23 23 23 23 23 31 23 23 23 23 23 23 31
31 23 23 23 23 23 23 23 23 23 23 23 23 23 23 23 23 23 23 23 23 23 23 23 23 23 23 23 23 23 23 23 23 23 23 31 23 23 23 23 23 23 31 23 23 23 23 23 23 31
31 23 23 23 23 23 23 23 23 23 23 23 23 23 23 23 23 23 23 23 23 23 23 23 23 23 23 23 23 23 23 23 23 23 23 31 23 23 23 23 23 23 31 23 23 23 23 23 23 31
31 53 53 53 53 53 53 53 53 23 23 23 53 53 53 53 53 53 53 53 53 23 23 23 23 23 23 23 23 23 23 23 23 23 23 31 23 23 23 23 23 23 31 23 23 23 23 23 23 31
31 54 54 54 54 54 54 54 54 23 23 23 54 54 54 54 54 54 54 54 54 23 23 23 23 23 23 23 23 23 23 23 23 23 23 31 23 23 23 23 23 23 31 23 23 23 23 23 23 31
31 54 54 54 54 54 54 54 54 23 23 23 54 54 54 54 54 54 54 54 54 23 23 23 23 23 23 23 23 23 23 23 23 23 23 31 23 23 23 23 23 23 31 23 23 23 23 23 23 31
31 53 53 53 53 53 53 53 53 23 23 23 53 53 53 53 53 53 53 53 53 23 23 23 23 23 23 23 23 23 23 23 23 23 23 31 23 23 23 23 23 23 31 23 23 23 23 23 23 31
31 23 23 23 23 23 23 23 23 23 23 23 23 23 23 23 23 23 23 23 23 23 23 23 23 23 23 23 23 23 23 23 23 23 23 31 23 23 23 23 23 23 23 23 23 23 23 23 23 31
31 23 23 23 23 23 23 23 23 23 23 23 23 23 23 23 23 23 23 23 23 23 23 23 23 23 23 23 23 23 23 23 23 23 23 31 23 23 23 23 23 23 23 23 23 23 23 23 23 31
31 53 53 53 53 53 53 53 53 23 23 23 23 23 23 23 23 23 23 23 23 23 23 23 23 23 23 23 23 23 23 23 23 23 23 31 31 31 23 23 23 23 23 23 23 23 23 23 23 31
31 54 54 54 54 54 54 54 54 23 23 23 23 23 23 23 23 23 23 23 23 23 23 23 23 23 23 23 23 23 23 23 23 23 23 23 23 23 23 23 23 23 23 23 23 23 23 23 23 31
31 54 54 54 54 54 54 54 54 23 23 23 23 23 23 23 23 23 23 23 23 23 23 23 23 23 23 23 23 23 23 23 23 23 23 23 23 23 23 23 23 23 23 23 23 23 23 23 23 31
31 53 53 53 53 53 53 53 53 23 23 23 23 23 23 23 23 23 23 23 23 23 23 23 23 23 23 23 23 23 23 23 23 23 23 23 23 23 23 23 23 23 23 23 23 23 23 23 23 31
31 23 23 23 23 23 23 23 23 23 23 23 23 23 23 23 23 23 23 23 23 23 23 23 23 23 23 23 23 30 30 30 30 30 30 23 23 23 23 23 23 23 23 23 23 23 23 23 23 31
31 53 53 53 53 53 53 53 53 23 23 23 23 23 23 23 23 23 23 23 23 23 23 23 23 23 23 23 23 31 23 23 23 23 31 23 23 23 23 23 23 23 23 23 23 23 23 23 23 31
31 23 23 23 23 23 23 23 23 23 23 23 23 23 23 23 23 23 23 23 23 23 23 23 23 23 23 23 23 31 23 23 23 23 31 23 23 23 23 23 23 23 23 23 23 23 23 23 23 31
31 54 54 54 54 54 54 54 54 23 23 23 23 23 23 23 23 23 23 23 23 23 23 23 23 23 23 23 23 31 23 23 23 23 31 23 23 23 23 23 23 23 23 23 23 23 23 23 23 31
31 54 54 54 54 54 54 54 54 23 23 23 23 23 23 23 23 23 23 23 23 23 23 23 23 23 23 23 23 30 30 30 30 30 30 23 23 23 23 23 23 23 23 23 23 23 23 23 23 31
31 53 53 53 53 53 53 53 53 23 23 23 23 23 23 23 23 23 23 23 23 23 23 23 23 23 23 23 23 23 23 23 23 23 23 23 23 23 23 23 23 23 23 23 23 23 23 23 23 31
31 23 23 23 23 23 23 23 23 23 23 23 23 23 23 23 23 23 23 23 23 23 23 23 23 23 23 23 23 23 23 23 23 23 23 23 23 23 23 23 23 23 23 23 23 23 23 23 23 31
31 23 23 23 23 23 23 23 23 23 23 23 23 23 23 23 23 23 23 23 23 23 23 23 23 23 23 23 23 23 23 23 23 23 23 23 23 23 23 23 23 23 23 23 23 23 23 23 23 31
23 23 23 23 23 23 23 23 23 23 23 23 23 23 23 23 23 23 23 23 23 23 23 23 23 23 23 23 23 23 23 23 23 23 23 23 23 23 23 23 23 23 23 23 23 23 23 23 23 31
23 23 23 23 23 23 23 23 23 23 23 23 23 23 23 23 23 23 23 23 23 23 23 23 23 23 23 23 23 23 23 23 23 23 23 23 23 23 23 23 23 23 23 23 23 23 23 23 23 31
23 23 23 23 23 23 23 23 23 23 23 23 23 23 23 23 23 23 23 23 23 23 23 23 23 23 23 23 23 23 23 23 23 23 23 23 23 23 23 23 23 23 23 23 23 23 23 23 23 31
31 23 23 23 23 23 23 23 23 23 23 23 23 23 23 23 23 23 23 23 23 23 23 23 23 23 23 23 23 23 23 23 23 23 23 23 23 23 23 23 23 23 23 23 23 23 23 23 23 31
33 33 33 33 33 33 33 33 33 33 33 33 33 33 33 33 33 33 33 33 33 33 33 33 33 25 25 25 33 33 33 33 33 33 33 33 33 33 33 33 33 33 33 33 33 33 33 33 33 33